,cycleway,footway,path,track,pedestrian,Total
User46,4864,2207,11474,24670,64,43279
User33,317,2550,11705,15015,64,29651
User17,975,23167,490,43,1133,25808
User31,897,1064,5405,7379,41,14786
User95,683,961,4490,4132,30,10296
User312,105,1751,942,6790,111,9699
User47,4780,957,1813,737,83,8370
User257,1453,4263,2002,273,57,8048
User213,92,292,658,6195,27,7264
User260,37,1160,2410,3441,21,7069
User258,16,460,1538,4751,18,6783
User54,1441,2326,1741,957,201,6666
User80,160,6057,208,28,113,6566
User48,618,2682,1815,1291,81,6487
User99,576,203,2616,2102,32,5529
User92,754,1647,1828,1077,28,5334
User7,831,2828,903,388,351,5301
User308,40,85,2738,2365,0,5228
User39,857,2673,777,752,126,5185
User264,7,28,517,4428,0,4980
User75,819,746,2005,1157,84,4811
User20,292,970,1650,1642,85,4639
User76,27,518,1958,1917,36,4456
User133,2052,595,1030,691,42,4410
User52,1466,1299,628,705,301,4399
User85,192,376,2560,1266,0,4394
User58,1005,1057,960,1197,70,4289
User1,1083,582,1670,524,149,4008
User43,697,960,1214,901,131,3903
User346,909,381,771,1205,15,3281
User136,313,684,1175,964,99,3235
User56,1023,285,1417,467,17,3209
User173,24,897,522,1716,33,3192
User265,107,512,510,1822,61,3012
User309,62,509,699,1659,19,2948
User9,1290,639,670,321,18,2938
User135,157,1257,331,1154,1,2900
User340,59,479,548,1720,9,2815
User119,155,1376,355,490,271,2647
User6,851,952,350,390,20,2563
User249,8,663,435,1431,23,2560
User212,10,2236,59,7,203,2515
User727,14,483,596,1130,0,2223
User40,45,1502,136,518,2,2203
User97,530,626,572,458,9,2195
User89,145,301,322,1344,19,2131
User371,84,338,1060,587,12,2081
User279,120,274,870,796,8,2068
User196,79,1927,13,4,33,2056
User8,270,813,744,205,14,2046
User489,8,11,317,1686,0,2022
User177,60,300,1356,236,11,1963
User109,73,812,304,756,5,1950
User588,135,551,638,527,29,1880
User810,14,129,223,1457,11,1834
User1712,1,1,775,991,0,1768
User74,22,242,173,1277,20,1734
User1286,79,865,147,613,17,1721
User996,6,323,446,923,0,1698
User221,147,354,510,628,24,1663
User422,171,993,147,262,70,1643
User67,669,661,203,54,26,1613
User51,20,131,376,1029,11,1567
User725,15,104,354,1047,1,1521
User321,10,352,165,977,14,1518
User358,413,272,556,254,12,1507
User239,33,569,580,298,13,1493
User53,248,276,710,240,4,1478
User21,182,278,184,734,6,1384
User1212,3,3,37,1335,0,1378
User174,244,513,310,287,4,1358
User498,9,23,273,1028,1,1334
User30,364,70,325,550,7,1316
User142,333,57,381,510,23,1304
User580,67,511,330,379,6,1293
User107,22,843,310,87,8,1270
User68,28,905,86,215,31,1265
User10,62,48,427,653,3,1193
User65,417,193,468,70,11,1159
User91,82,740,147,67,120,1156
User49,376,334,215,5,184,1114
User90,245,522,204,101,30,1102
User1053,3,973,30,51,34,1091
User241,73,963,14,1,27,1078
User390,22,325,465,225,1,1038
User141,182,373,141,325,6,1027
User164,100,580,32,38,235,985
User360,379,111,235,235,18,978
User115,19,308,240,405,5,977
User339,4,244,316,409,0,973
User734,80,158,429,253,2,922
User179,20,204,530,148,15,917
User300,51,83,453,320,7,914
User171,117,172,405,197,17,908
User176,15,322,292,245,11,885
User266,9,106,386,381,2,884
User1557,19,80,47,729,4,879
User458,40,202,416,197,11,866
User208,139,335,211,137,31,853
User293,53,353,343,93,10,852
User188,244,16,361,226,1,848
User228,396,83,108,242,4,833
User743,25,600,59,27,102,813
User326,4,467,79,245,8,803
User232,68,492,152,58,10,780
User826,6,34,638,94,2,774
User607,166,378,121,80,18,763
User562,19,128,333,265,0,745
User104,39,614,41,32,13,739
User583,33,38,659,2,5,737
User310,6,369,131,207,22,735
User29,324,265,44,43,22,698
User689,16,510,40,54,61,681
User35,1,300,188,143,33,665
User291,63,68,171,358,2,662
User412,57,438,54,98,14,661
User1073,9,91,237,319,0,656
User511,70,202,173,177,12,634
User461,117,291,84,115,16,623
User12,137,440,11,1,31,620
User345,1,15,90,509,0,615
User537,42,228,208,118,17,613
User1170,0,185,227,193,1,606
User619,21,48,373,160,0,602
User302,2,163,209,217,1,592
User1836,0,9,166,400,0,575
User263,0,4,328,241,0,573
User137,11,53,98,407,0,569
User324,8,40,306,213,1,568
User839,3,202,208,145,6,564
User2,44,456,39,18,3,560
User452,101,95,171,113,76,556
User387,8,390,120,22,11,551
User32,10,20,356,163,0,549
User186,28,283,109,117,12,549
User190,30,348,118,10,37,543
User573,108,179,126,117,9,539
User127,86,180,217,15,41,539
User169,56,87,205,172,14,534
User70,68,48,274,144,0,534
User1168,0,135,73,315,0,523
User434,0,44,95,370,0,509
User159,1,79,13,411,3,507
User296,175,147,150,26,3,501
User1487,15,34,307,142,3,501
User116,357,21,92,23,8,501
User244,18,33,198,228,23,500
User396,54,43,115,271,5,488
User504,11,56,264,149,3,483
User1285,122,223,63,54,19,481
User784,5,3,79,382,0,469
User44,36,182,125,119,0,462
User1619,31,60,327,40,1,459
User401,71,145,92,114,12,434
User542,51,93,269,18,2,433
User187,41,72,113,202,5,433
User1394,3,52,56,319,0,430
User101,269,12,38,108,3,430
User797,0,6,0,421,0,427
User397,29,238,56,45,51,419
User423,144,181,30,59,5,419
User1461,3,25,24,359,6,417
User281,10,147,166,88,3,414
User275,26,134,194,56,2,412
User1052,13,342,39,12,6,412
User773,0,2,120,285,0,407
User226,95,142,84,83,0,404
User903,99,194,67,42,1,403
User165,15,200,130,34,23,402
User437,91,252,50,5,2,400
User110,2,7,15,373,0,397
User966,18,152,96,126,4,396
User1302,34,48,77,224,12,395
User218,44,231,79,13,26,393
User1777,75,229,50,22,13,389
User140,42,125,115,101,3,386
User799,6,8,34,335,0,383
User1564,6,46,63,266,0,381
User126,72,93,130,81,3,379
User211,35,280,13,1,46,375
User1625,91,85,173,11,12,372
User278,42,162,116,43,7,370
User747,5,347,9,3,4,368
User103,38,39,51,229,10,367
User277,64,135,140,19,6,364
User1343,6,145,68,137,4,360
User603,20,82,114,143,1,360
User1185,2,236,47,73,1,359
User124,26,20,190,123,0,359
User112,78,101,133,42,1,355
User162,102,133,74,43,2,354
User357,29,103,138,75,5,350
User526,35,77,132,101,3,348
User2108,2,70,61,211,0,344
User612,19,93,204,22,5,343
User1429,0,321,11,4,5,341
User502,1,260,12,59,0,332
User25,169,129,29,5,0,332
User1471,2,92,80,153,4,331
User88,196,64,21,48,1,330
User100,27,106,22,168,6,329
User163,23,214,46,38,7,328
User675,1,243,57,20,3,324
User681,23,98,136,61,3,321
User939,20,87,84,124,5,320
User313,14,142,147,14,2,319
User760,42,216,47,10,4,319
User373,53,30,81,155,0,319
User625,24,74,78,137,6,319
User377,89,22,127,57,19,314
User1136,131,16,47,118,0,312
User1272,19,104,105,61,22,311
User155,70,16,47,178,0,311
User332,22,244,20,23,2,311
User1085,11,4,99,197,0,311
User1807,0,16,185,109,0,310
User506,19,87,107,67,30,310
User515,3,201,30,73,2,309
User14,9,163,84,10,41,307
User1761,21,65,110,102,8,306
User610,1,166,35,99,4,305
User1046,8,165,61,67,4,305
User892,31,99,53,119,2,304
User229,31,233,28,2,10,304
User255,22,30,117,121,11,301
User1221,8,170,38,74,8,298
User1045,102,51,116,22,4,295
User298,4,117,39,6,128,294
User150,9,59,118,107,0,293
User520,11,30,80,171,0,292
User1896,27,40,210,14,0,291
User132,2,165,95,27,0,289
User50,55,187,24,1,21,288
User2120,88,32,88,80,0,288
User2379,6,115,64,101,1,287
User795,11,40,94,141,0,286
User525,0,37,130,116,0,283
User538,0,255,1,10,17,283
User735,29,169,63,18,0,279
User447,26,180,29,37,2,274
User476,8,74,107,79,1,269
User690,23,50,93,100,2,268
User565,0,32,170,63,0,265
User234,2,19,77,164,1,263
User269,1,28,81,151,0,261
User2398,0,207,25,29,0,261
User334,9,43,142,64,0,258
User363,38,70,116,27,6,257
User1236,0,42,77,136,0,255
User419,42,141,23,5,43,254
User1386,35,66,42,103,5,251
User1805,18,119,77,31,6,251
User181,11,87,33,86,32,249
User24,73,103,51,9,11,247
User2010,2,203,40,0,0,245
User1363,11,32,121,80,0,244
User2232,1,243,0,0,0,244
User236,0,72,127,38,6,243
User540,34,83,101,24,0,242
User1087,1,225,7,4,3,240
User782,0,2,10,227,0,239
User81,51,30,59,23,76,239
User491,48,88,57,45,0,238
User532,31,11,61,132,0,235
User2307,0,0,154,78,1,233
User695,12,187,3,6,24,232
User320,64,138,14,9,0,225
User475,19,111,63,23,9,225
User692,73,119,8,1,19,220
User843,42,69,86,8,14,219
User736,16,77,91,35,0,219
User240,6,27,48,137,1,219
User1205,25,93,72,23,6,219
User429,2,9,110,98,0,219
User880,12,88,23,92,4,219
User114,1,113,34,65,5,218
User644,18,67,70,60,1,216
User271,3,142,17,47,4,213
User274,24,39,65,76,9,213
User908,47,56,54,51,4,212
User706,10,45,78,78,1,212
User878,26,76,90,19,1,212
User207,8,29,138,16,20,211
User242,0,20,92,99,0,211
User496,3,0,92,115,0,210
User2556,0,203,5,2,0,210
User1581,0,16,141,52,0,209
User1556,4,39,46,116,2,207
User1180,0,12,91,102,0,205
User749,5,25,85,88,0,203
User1523,2,1,1,198,0,202
User641,1,34,56,110,0,201
User534,1,63,73,62,2,201
User1238,107,44,30,17,2,200
User220,36,82,79,1,1,199
User2451,162,15,3,18,0,198
User2055,6,20,134,36,1,197
User1083,2,26,115,53,0,196
User1653,20,28,84,63,1,196
User1287,5,53,42,92,3,195
User487,0,34,53,96,10,193
User1006,10,99,52,23,8,192
User1005,5,180,1,5,0,191
User482,2,58,56,72,2,190
User554,72,89,8,19,1,189
User2329,11,46,121,10,1,189
User3657,0,162,20,7,0,189
User1450,1,163,14,9,1,188
User786,6,65,31,79,7,188
User1588,51,37,68,26,5,187
User918,6,119,24,20,15,184
User1594,0,2,12,169,0,183
User2109,0,0,118,65,0,183
User722,39,116,21,1,5,182
User1274,4,13,92,70,0,179
User729,11,14,61,92,0,178
User1049,45,91,35,2,3,176
User57,25,61,60,28,1,175
User184,25,97,41,8,4,175
User1508,1,74,26,73,0,174
User323,25,14,62,72,0,173
User890,1,91,41,40,0,173
User512,32,82,5,53,0,172
User744,2,29,116,25,0,172
User66,0,89,16,67,0,172
User1784,0,68,92,12,0,172
User910,16,19,6,122,8,171
User1007,23,80,45,15,8,171
User1204,11,35,121,0,2,169
User156,31,54,48,31,4,168
User488,0,1,85,82,0,168
User1623,18,35,60,53,1,167
User1823,0,132,33,0,1,166
User276,29,61,46,28,1,165
User711,24,43,43,55,0,165
User1679,1,16,33,113,0,163
User517,4,17,12,130,0,163
User1058,25,26,51,60,0,162
User1125,14,22,54,72,0,162
User227,19,39,65,29,9,161
User347,35,37,35,54,0,161
User571,2,33,28,95,2,160
User1817,0,1,88,71,0,160
User1331,48,49,41,18,4,160
User342,0,10,67,83,0,160
User286,31,78,34,14,2,159
User292,25,42,40,48,1,156
User439,19,6,75,55,0,155
User322,4,142,3,2,4,155
User1684,5,71,10,68,0,154
User87,41,54,18,14,26,153
User1810,14,115,19,3,0,151
User631,0,20,10,121,0,151
User204,54,42,35,17,2,150
User924,5,4,89,50,1,149
User62,73,27,43,4,2,149
User1998,0,19,76,53,0,148
User965,5,63,35,32,12,147
User1560,0,108,24,14,0,146
User372,12,78,18,28,9,145
User183,3,29,41,71,0,144
User674,13,29,52,48,2,144
User975,1,38,41,63,0,143
User617,24,38,19,56,6,143
User1775,21,43,79,0,0,143
User466,22,67,31,18,5,143
User362,20,79,20,13,10,142
User197,18,56,29,19,19,141
User676,0,85,34,7,13,139
User741,21,11,43,64,0,139
User2291,2,17,24,95,0,138
User446,24,9,63,40,2,138
User348,57,71,4,2,3,137
User405,2,17,12,104,2,137
User1309,3,70,41,20,2,136
User375,25,71,25,2,13,136
User94,6,7,91,31,0,135
User1827,4,0,29,101,0,134
User1437,3,44,28,56,3,134
User61,47,5,52,29,0,133
User128,14,66,24,19,10,133
User946,4,98,11,16,4,133
User1436,1,51,47,34,0,133
User1357,2,20,59,51,0,132
User2531,0,38,19,74,0,131
User1418,23,66,32,4,5,130
User448,10,67,29,21,3,130
User192,4,30,58,36,1,129
User1113,0,5,16,107,0,128
User111,37,42,23,17,9,128
User4,42,50,20,13,2,127
User2302,2,15,7,103,0,127
User1057,10,18,59,37,2,126
User314,1,31,5,89,0,126
User354,5,19,40,62,0,126
User1165,0,64,41,20,0,125
User120,49,30,41,4,0,124
User480,23,3,70,28,0,124
User154,42,35,27,18,2,124
User1043,3,107,8,0,5,123
User875,2,77,4,40,0,123
User998,0,49,49,24,1,123
User1076,0,119,4,0,0,123
User216,46,63,12,0,0,121
User1395,0,69,14,38,0,121
User2455,1,72,26,21,0,120
User230,74,30,4,10,2,120
User86,19,35,34,32,0,120
User167,17,99,2,1,1,120
User2048,9,42,31,38,0,120
User564,9,43,14,53,1,120
User524,1,6,64,47,0,118
User548,22,6,53,37,0,118
User803,0,0,31,86,0,117
User352,37,33,33,7,7,117
User1374,4,8,23,82,0,117
User584,11,72,27,5,0,115
User294,37,33,17,6,22,115
User567,20,36,52,6,1,115
User1632,4,18,24,68,1,115
User219,16,62,25,2,9,114
User501,7,6,27,73,0,113
User63,4,19,56,32,2,113
User73,0,7,5,100,0,112
User522,2,27,15,67,0,111
User304,0,86,15,10,0,111
User117,66,25,9,1,10,111
User416,13,7,29,59,0,108
User3919,0,49,59,0,0,108
User697,22,12,33,40,0,107
User1242,2,93,2,0,9,106
User93,1,6,55,44,0,106
User3678,0,105,1,0,0,106
User148,74,17,5,5,4,105
User1101,12,16,63,14,0,105
User306,0,88,11,3,3,105
User28,10,29,46,12,7,104
User1016,17,22,61,4,0,104
User1263,1,101,1,0,1,104
User633,15,9,26,54,0,104
User130,11,3,53,37,0,104
User1322,9,41,33,17,4,104
User288,62,11,18,12,0,103
User41,26,65,9,3,0,103
User1027,1,83,9,5,4,102
User1097,4,65,3,0,30,102
User1713,0,17,18,67,0,102
User940,0,4,6,92,0,102
User381,51,28,4,0,19,102
User106,17,31,45,8,1,102
User813,0,7,39,55,0,101
User627,6,32,30,30,2,100
User158,17,44,11,28,0,100
User1088,2,4,51,43,0,100
User700,4,81,8,0,7,100
User830,5,65,25,1,3,99
User366,0,15,20,63,1,99
User455,7,57,18,13,4,99
User1958,4,23,63,8,1,99
User1217,0,46,20,31,1,98
User1353,0,10,14,73,0,97
User1115,7,53,18,16,2,96
User1771,0,2,59,35,0,96
User523,4,40,27,21,3,95
User222,23,20,18,32,2,95
User712,5,36,22,30,1,94
User563,4,74,13,0,3,94
User472,55,25,2,0,11,93
User1447,35,44,6,2,6,93
User2198,0,0,74,19,0,93
User1411,6,60,18,7,2,93
User535,1,1,73,18,0,93
User2884,0,7,52,33,0,92
User462,4,34,47,2,5,92
User3466,5,0,72,15,0,92
User514,21,27,12,32,0,92
User1933,0,0,38,54,0,92
User837,0,28,26,38,0,92
User1837,0,42,22,27,0,91
User259,20,34,19,18,0,91
User1687,7,22,46,16,0,91
User26,6,62,5,14,4,91
User1665,1,0,40,49,0,90
User649,1,22,38,28,0,89
User999,2,0,50,36,0,88
User1843,5,56,13,13,1,88
User237,0,3,43,42,0,88
User72,38,13,14,20,2,87
User702,3,2,32,50,0,87
User2774,2,17,21,47,0,87
User1869,0,83,3,0,1,87
User1604,3,40,0,43,0,86
User638,13,26,38,6,3,86
User713,16,20,29,16,5,86
User831,33,34,7,12,0,86
User2057,51,8,12,15,0,86
User2013,22,20,27,17,0,86
User1607,35,44,4,2,0,85
User15,3,65,1,0,16,85
User318,8,3,37,37,0,85
User533,1,31,10,40,2,84
User955,12,6,49,16,1,84
User210,4,51,26,1,1,83
User1903,18,7,56,2,0,83
User2290,2,70,4,0,6,82
User1380,3,12,60,7,0,82
User1875,4,38,39,1,0,82
User549,1,81,0,0,0,82
User609,2,30,31,19,0,82
User3109,0,9,8,64,1,82
User860,0,1,19,62,0,82
User1390,2,47,19,13,0,81
User284,1,1,17,62,0,81
User815,0,14,48,18,0,80
User1662,0,62,13,1,4,80
User319,2,12,50,15,1,80
User2443,5,28,44,3,0,80
User1220,0,45,22,11,2,80
User1462,0,4,4,72,0,80
User327,23,32,18,6,0,79
User1595,0,0,68,11,0,79
User943,1,47,21,7,2,78
User2523,0,2,51,25,0,78
User2035,0,2,6,70,0,78
User720,30,29,10,9,0,78
User1178,0,1,41,36,0,78
User433,0,1,52,25,0,78
User427,46,7,6,11,7,77
User105,27,10,17,18,5,77
User913,0,74,2,1,0,77
User2086,0,2,74,0,1,77
User1381,30,0,44,3,0,77
User1179,3,7,5,62,0,77
User1544,23,13,13,27,1,77
User175,1,36,4,35,0,76
User861,0,33,24,13,6,76
User1304,1,10,33,32,0,76
User2649,26,14,26,10,0,76
User505,1,16,8,51,0,76
User1146,4,65,6,0,0,75
User904,0,1,74,0,0,75
User64,5,8,1,0,61,75
User456,0,5,24,46,0,75
User289,2,1,48,24,0,75
User118,11,43,19,2,0,75
User1261,2,44,27,0,1,74
User765,1,56,12,4,1,74
User290,8,58,0,0,8,74
User18,5,30,4,6,29,74
User1300,0,3,35,35,0,73
User1945,3,21,9,40,0,73
User83,7,54,0,0,12,73
User2605,31,31,9,0,2,73
User1325,14,40,15,3,1,73
User1477,0,51,4,17,0,72
User643,0,1,27,44,0,72
User160,23,27,15,7,0,72
User272,24,28,11,6,3,72
User1335,0,39,19,14,0,72
User1061,2,21,6,42,0,71
User217,22,25,9,14,1,71
User647,2,23,4,42,0,71
User1987,6,30,35,0,0,71
User869,0,5,36,30,0,71
User369,0,0,2,69,0,71
User1533,4,21,22,24,0,71
User1859,0,4,36,30,0,70
User785,19,11,8,31,1,70
User303,23,19,10,17,1,70
User2257,13,34,14,9,0,70
User882,6,21,43,0,0,70
User2103,5,58,3,1,3,70
User199,12,31,17,6,3,69
User1445,45,13,4,7,0,69
User2054,1,0,8,60,0,69
User406,1,1,3,64,0,69
User3065,1,42,6,20,0,69
User200,0,21,20,28,0,69
User359,7,49,5,3,5,69
User2033,0,14,24,31,0,69
User1897,1,8,9,51,0,69
User1030,2,43,12,11,0,68
User1423,0,15,24,29,0,68
User1507,9,23,11,12,13,68
User206,6,12,22,23,5,68
User431,2,13,5,36,12,68
User1116,17,41,4,4,2,68
User1650,0,0,38,30,0,68
User2210,0,38,10,19,1,68
User1547,3,3,30,32,0,68
User876,28,14,7,16,2,67
User1872,3,21,8,34,1,67
User1283,3,4,31,29,0,67
User2166,0,66,1,0,0,67
User853,2,45,19,0,1,67
User728,0,0,1,65,0,66
User71,29,7,17,13,0,66
User1228,0,59,1,4,1,65
User1551,2,62,1,0,0,65
User407,3,10,23,19,10,65
User1483,5,11,4,44,1,65
User897,5,14,29,17,0,65
User899,3,27,9,23,3,65
User2458,0,37,22,6,0,65
User98,9,31,6,19,0,65
User598,8,36,3,12,6,65
User2356,1,8,54,2,0,65
User833,2,27,23,11,2,65
User2203,0,2,19,44,0,65
User874,0,6,34,24,0,64
User2274,2,3,46,13,0,64
User1481,0,0,23,41,0,64
User530,9,1,48,6,0,64
User270,4,16,18,26,0,64
User1203,19,2,30,12,1,64
User185,21,21,9,12,1,64
User780,0,0,3,58,3,64
User2263,0,49,6,8,0,63
User805,5,8,1,49,0,63
User2909,2,17,37,6,1,63
User1099,28,17,10,1,7,63
User2359,0,0,0,63,0,63
User2129,3,46,8,5,0,62
User1426,2,3,11,46,0,62
User182,7,41,4,1,9,62
User2485,3,48,7,0,4,62
User3325,1,36,7,13,5,62
User1171,2,26,11,21,2,62
User900,5,25,15,13,4,62
User2252,0,0,4,57,0,61
User1680,1,31,4,25,0,61
User411,5,46,3,0,7,61
User1659,4,54,2,0,1,61
User1200,2,37,13,8,1,61
User2371,1,46,1,13,0,61
User1028,4,0,20,37,0,61
User2760,1,60,0,0,0,61
User470,0,59,0,0,2,61
User2400,0,4,27,29,0,60
User954,1,2,24,33,0,60
User1525,23,8,11,18,0,60
User1908,12,19,28,0,1,60
User873,2,0,31,26,0,59
User993,3,0,16,40,0,59
User329,1,45,8,4,1,59
User791,0,46,3,10,0,59
User945,4,11,22,13,9,59
User385,18,9,17,15,0,59
User1479,0,16,15,28,0,59
User1791,0,58,0,1,0,59
User328,3,50,0,5,0,58
User13,30,15,3,9,1,58
User836,1,55,2,0,0,58
User3343,0,42,10,1,5,58
User108,6,29,4,19,0,58
User1067,29,23,3,3,0,58
User585,7,1,15,35,0,58
User4410,1,53,4,0,0,58
User454,5,7,28,18,0,58
User436,2,2,7,47,0,58
User5343,0,58,0,0,0,58
User931,10,23,20,1,3,57
User2796,0,44,7,6,0,57
User1911,18,34,2,2,1,57
User1760,4,7,24,22,0,57
User404,5,31,3,9,9,57
User2326,0,1,6,50,0,57
User3949,0,8,14,35,0,57
User1216,1,20,16,19,1,57
User1430,1,10,24,22,0,57
User1849,4,33,0,20,0,57
User1153,0,1,20,36,0,57
User5299,1,56,0,0,0,57
User1258,1,51,0,0,4,56
User1658,3,52,1,0,0,56
User1638,4,44,6,2,0,56
User121,31,12,13,0,0,56
User1054,3,37,6,10,0,56
User430,32,16,4,0,4,56
User2950,3,47,0,2,4,56
User2471,0,0,16,40,0,56
User457,7,6,24,19,0,56
User1021,3,5,7,41,0,56
User2078,0,0,52,3,0,55
User102,0,9,24,22,0,55
User2628,0,47,4,4,0,55
User1075,1,0,1,53,0,55
User252,0,7,19,29,0,55
User1520,0,10,36,9,0,55
User855,4,13,23,13,2,55
User1042,1,0,2,51,1,55
User45,19,29,2,5,0,55
User1208,18,24,7,5,1,55
User69,7,27,2,18,0,54
User2018,0,6,40,8,0,54
User215,4,5,9,36,0,54
User1517,1,9,33,11,0,54
User3097,2,7,14,31,0,54
User1359,0,33,17,2,2,54
User2028,0,52,1,0,0,53
User1661,0,43,5,3,2,53
User1259,11,12,14,16,0,53
User979,1,39,6,7,0,53
User180,28,12,6,4,3,53
User1207,1,8,39,4,0,52
User1037,15,35,1,1,0,52
User1941,3,7,29,13,0,52
User3037,23,21,5,3,0,52
User1558,33,3,2,14,0,52
User774,0,49,0,1,2,52
User759,7,16,15,10,4,52
User1330,23,4,22,3,0,52
User2868,1,49,0,0,2,52
User1189,0,13,4,35,0,52
User383,1,2,44,2,2,51
User2126,0,0,9,42,0,51
User444,7,8,31,4,1,51
User4990,12,20,18,1,0,51
User895,7,25,19,0,0,51
User1500,0,10,17,24,0,51
User4813,2,48,0,0,1,51
User5608,0,0,51,0,0,51
User1476,0,16,10,25,0,51
User2665,0,30,18,3,0,51
User77,11,36,0,3,0,50
User1246,1,18,13,18,0,50
User449,0,28,10,6,6,50
User2242,0,8,26,16,0,50
User682,0,32,5,13,0,50
User2467,2,2,43,3,0,50
User1509,14,8,20,8,0,50
User2622,0,9,4,37,0,50
User2046,0,3,0,47,0,50
User2468,1,8,24,15,2,50
User214,2,46,0,1,0,49
User703,6,9,4,30,0,49
User1362,0,1,2,46,0,49
User134,40,5,2,1,1,49
User2806,0,20,12,17,0,49
User413,19,8,8,14,0,49
User1636,0,0,33,16,0,49
User1546,1,15,10,17,6,49
User361,34,5,2,0,8,49
User1296,11,11,17,9,1,49
User370,1,1,24,22,0,48
User1569,1,0,19,28,0,48
User1881,0,32,13,2,1,48
User2487,20,20,5,3,0,48
User1280,0,48,0,0,0,48
User1743,0,20,10,18,0,48
User3444,0,5,13,30,0,48
User3679,3,45,0,0,0,48
User350,21,9,10,4,4,48
User1385,8,9,8,23,0,48
User2026,0,0,20,27,0,47
User1434,4,43,0,0,0,47
User1694,0,8,11,28,0,47
User972,7,18,15,7,0,47
User285,5,20,22,0,0,47
User1813,0,37,5,5,0,47
User1663,2,20,3,9,12,46
User579,20,20,5,1,0,46
User287,38,1,0,7,0,46
User1735,11,8,14,0,13,46
User1587,2,13,19,4,8,46
User824,2,13,8,21,2,46
User1628,0,0,0,46,0,46
User1871,4,7,12,23,0,46
User2271,0,23,2,19,2,46
User2620,0,1,44,1,0,46
User2540,0,45,1,0,0,46
User714,17,8,2,19,0,46
User1306,5,9,12,19,0,45
User527,2,37,2,3,1,45
User821,5,0,5,35,0,45
User2592,1,25,7,9,3,45
User2765,0,34,6,5,0,45
User246,2,33,1,9,0,45
User1631,6,37,0,2,0,45
User3640,0,5,24,16,0,45
User1766,4,16,9,16,0,45
User2436,10,15,14,6,0,45
User1918,0,6,27,11,0,44
User1852,5,22,2,13,2,44
User3656,27,10,4,3,0,44
User518,1,14,13,16,0,44
User1621,1,11,24,7,1,44
User672,0,7,26,11,0,44
User1692,1,31,4,8,0,44
User1079,7,7,21,8,1,44
User425,20,11,3,10,0,44
User623,1,16,15,11,0,43
User3133,0,3,18,22,0,43
User2874,0,18,3,22,0,43
User1438,0,23,5,15,0,43
User1198,0,27,0,16,0,43
User600,1,26,1,0,15,43
User2246,0,35,0,8,0,43
User2259,0,42,0,1,0,43
User559,0,26,15,2,0,43
User1164,0,36,3,1,3,43
User331,0,36,0,0,7,43
User4133,0,35,8,0,0,43
User4157,0,33,6,4,0,43
User1593,1,26,2,14,0,43
User912,1,4,34,4,0,43
User985,3,8,32,0,0,43
User261,4,8,22,9,0,43
User4589,0,0,41,1,0,42
User669,2,0,5,35,0,42
User2029,0,17,14,11,0,42
User550,17,14,6,5,0,42
User1132,0,32,2,8,0,42
User911,18,8,10,6,0,42
User2914,15,18,4,5,0,42
User1036,28,10,0,3,0,41
User2038,0,1,23,17,0,41
User3746,14,10,6,11,0,41
User1758,0,2,12,27,0,41
User1787,1,15,10,15,0,41
User2125,6,11,18,6,0,41
User2541,0,5,13,23,0,41
User349,5,34,0,0,2,41
User2163,0,1,11,29,0,41
User394,15,23,0,0,3,41
User694,6,18,12,0,5,41
User680,0,10,24,7,0,41
User1562,0,1,29,10,1,41
User1830,6,0,7,28,0,41
User2202,1,14,4,21,0,40
User671,0,24,10,6,0,40
User2300,0,34,0,6,0,40
User1482,7,11,16,6,0,40
User1821,0,0,24,16,0,40
User4004,0,22,17,1,0,40
User251,1,16,18,5,0,40
User395,20,3,0,0,17,40
User1123,0,22,16,1,0,39
User400,0,14,10,14,1,39
User55,30,0,8,1,0,39
User987,2,19,16,1,1,39
User948,0,31,3,5,0,39
User665,30,8,1,0,0,39
User2690,0,0,3,36,0,39
User663,1,34,0,4,0,39
User2310,21,9,7,2,0,39
User1664,0,4,16,19,0,39
User1676,3,16,12,8,0,39
User1976,0,35,4,0,0,39
User490,0,0,12,26,0,38
User1910,0,33,3,2,0,38
User1796,0,32,0,3,3,38
User4992,0,2,35,1,0,38
User478,11,1,6,20,0,38
User235,0,1,20,17,0,38
User3560,1,0,27,10,0,38
User315,0,25,5,8,0,38
User2515,0,16,9,13,0,38
User1762,0,0,27,11,0,38
User1691,1,24,3,8,2,38
User2640,13,11,10,3,1,38
User1745,1,7,17,13,0,38
User325,14,10,1,6,6,37
User2858,2,16,0,19,0,37
User262,18,13,3,3,0,37
User1959,0,3,31,3,0,37
User2557,1,0,35,1,0,37
User1360,0,24,2,11,0,37
User2262,0,14,18,5,0,37
User576,15,9,3,4,6,37
User256,12,8,12,4,0,36
User1337,4,11,6,15,0,36
User492,1,0,18,17,0,36
User1427,2,28,2,4,0,36
User1401,2,10,18,6,0,36
User788,0,6,27,1,2,36
User36,7,8,7,14,0,36
User460,3,19,1,12,1,36
User2449,20,1,5,10,0,36
User509,0,4,14,17,1,36
User3471,0,11,23,0,2,36
User1808,1,13,8,14,0,36
User1176,0,0,4,32,0,36
User203,1,5,27,2,0,35
User710,0,4,24,7,0,35
User1883,12,3,16,4,0,35
User170,1,31,1,0,2,35
User513,3,25,5,2,0,35
User474,9,17,9,0,0,35
User2570,0,27,4,4,0,35
User1130,0,0,30,5,0,35
User721,1,2,2,30,0,35
User536,0,0,18,17,0,35
User3934,1,29,2,1,1,34
User1554,0,6,8,19,1,34
User981,2,6,12,14,0,34
User1893,3,16,15,0,0,34
User337,19,12,1,1,1,34
User2784,0,1,19,14,0,34
User3328,0,0,11,23,0,34
User2183,0,0,18,16,0,34
User539,8,15,7,2,2,34
User597,0,0,13,21,0,34
User3840,7,7,5,15,0,34
User1640,3,23,4,4,0,34
User1770,0,1,3,30,0,34
User949,4,25,2,1,2,34
User2056,1,0,23,10,0,34
User927,7,1,19,5,1,33
User1064,1,0,6,26,0,33
User992,4,1,19,9,0,33
User123,5,7,3,17,1,33
User1356,8,16,8,1,0,33
User2287,1,18,3,10,1,33
User688,0,6,3,24,0,33
User1031,0,11,9,12,1,33
User1706,9,13,6,4,1,33
User1264,3,6,7,17,0,33
User2107,1,32,0,0,0,33
User1566,2,12,3,15,1,33
User2985,0,0,0,33,0,33
User1651,0,4,5,24,0,33
User1038,1,21,10,1,0,33
User1399,5,3,7,17,0,32
User1400,15,3,6,8,0,32
User1078,0,26,3,3,0,32
User1782,13,9,0,10,0,32
User3001,14,7,9,2,0,32
User1847,1,19,8,4,0,32
User1111,3,2,6,19,2,32
User2924,0,0,7,25,0,32
User4006,0,4,0,28,0,32
User1922,1,5,19,6,1,32
User2896,0,32,0,0,0,32
User2491,1,3,9,19,0,32
User27,13,14,2,3,0,32
User637,0,12,15,5,0,32
User201,0,23,2,7,0,32
User1440,12,2,14,0,3,31
User494,2,21,3,5,0,31
User353,2,3,26,0,0,31
User3100,4,2,19,6,0,31
User519,0,8,13,4,6,31
User2850,1,6,12,12,0,31
User1011,7,8,4,12,0,31
User2750,0,14,5,12,0,31
User1062,0,30,0,0,1,31
User3301,0,23,6,1,1,31
User338,0,1,18,12,0,31
User2608,1,19,2,9,0,31
User2119,7,10,5,8,1,31
User2923,0,0,7,24,0,31
User2066,0,1,19,11,0,31
User632,1,3,24,3,0,31
User1144,0,12,2,17,0,31
User1909,0,7,13,11,0,31
User3461,4,21,5,1,0,31
User1157,17,0,5,9,0,31
User1014,0,20,0,5,6,31
User1268,0,4,12,15,0,31
User1989,2,9,6,14,0,31
User2181,0,3,3,24,0,30
User1609,0,2,14,14,0,30
User1744,0,0,19,11,0,30
User3455,0,29,0,1,0,30
User1930,2,3,18,7,0,30
User2130,0,1,18,11,0,30
User1155,1,4,7,18,0,30
User974,2,8,16,4,0,30
User2184,0,0,26,4,0,30
User2024,0,26,1,1,2,30
User2529,0,0,1,29,0,30
User2236,2,0,1,27,0,30
User1243,9,1,7,13,0,30
User2838,3,20,4,1,2,30
User2079,2,0,19,9,0,30
User770,30,0,0,0,0,30
User1320,1,8,12,8,1,30
User2318,3,17,3,7,0,30
User2087,4,26,0,0,0,30
User1571,0,16,1,2,10,29
User1606,10,4,7,4,4,29
User1963,13,4,1,10,1,29
User640,26,1,1,1,0,29
User3720,0,11,16,2,0,29
User769,0,0,28,1,0,29
User5230,0,3,26,0,0,29
User3743,1,20,3,2,3,29
User2544,0,25,3,1,0,29
User2593,0,0,20,9,0,29
User3194,0,13,16,0,0,29
User2265,4,2,16,7,0,29
User403,8,8,2,0,11,29
User687,0,4,2,23,0,29
User2881,0,18,3,7,1,29
User1092,0,7,8,13,1,29
User1376,6,18,5,0,0,29
User2409,0,4,23,2,0,29
User621,1,4,11,12,0,28
User2404,0,2,16,10,0,28
User2583,0,0,9,19,0,28
User402,1,20,3,0,4,28
User748,0,25,3,0,0,28
User5558,0,0,28,0,0,28
User1224,3,5,11,9,0,28
User3137,0,2,4,22,0,28
User1182,0,12,3,2,11,28
User717,7,2,3,16,0,28
User1578,0,8,17,3,0,28
User443,17,0,2,9,0,28
User1723,0,0,2,26,0,28
User1803,28,0,0,0,0,28
User1741,0,28,0,0,0,28
User715,11,4,7,4,1,27
User1816,2,25,0,0,0,27
User2334,1,6,15,5,0,27
User2272,0,22,0,1,4,27
User374,1,0,0,25,1,27
User816,5,11,7,4,0,27
User1754,2,0,22,3,0,27
User1919,4,12,6,3,2,27
User779,0,3,0,24,0,27
User3127,0,4,23,0,0,27
User3349,0,1,26,0,0,27
User2932,1,9,9,8,0,27
User3766,1,23,1,2,0,27
User655,0,0,0,27,0,27
User209,0,21,5,1,0,27
User2281,0,1,11,15,0,27
User3036,4,16,4,3,0,27
User5660,0,27,0,0,0,27
User2321,2,0,2,23,0,27
User2071,0,23,2,1,1,27
User507,3,0,22,0,2,27
User2199,13,0,13,1,0,27
User962,2,20,1,4,0,27
User661,1,14,11,0,0,26
User1066,3,0,10,13,0,26
User254,1,8,7,10,0,26
User3206,11,5,6,0,4,26
User2220,4,5,14,3,0,26
User1860,0,1,4,21,0,26
User1338,0,0,22,4,0,26
User2664,0,0,14,12,0,26
User3106,0,11,14,0,1,26
User1906,10,4,8,4,0,26
User560,0,17,5,4,0,26
User3054,3,12,9,2,0,26
User556,0,19,3,4,0,26
User840,0,7,5,1,13,26
User2998,1,6,10,9,0,26
User1379,0,1,23,2,0,26
User483,1,8,0,17,0,26
User3095,0,23,1,2,0,26
User2043,0,0,12,14,0,26
User2218,0,19,2,5,0,26
User812,1,4,20,1,0,26
User3459,0,1,2,23,0,26
User1056,0,7,7,12,0,26
User3263,1,6,1,18,0,26
User1615,0,1,3,22,0,26
User465,3,20,2,0,1,26
User479,21,0,5,0,0,26
User3489,0,1,24,1,0,26
User626,0,3,17,6,0,26
User879,2,0,2,22,0,26
User1644,0,3,5,18,0,26
User645,0,3,2,21,0,26
User178,10,14,1,0,1,26
User1714,5,5,12,4,0,26
User1018,5,7,8,6,0,26
User4472,0,26,0,0,0,26
User1763,0,6,10,10,0,26
User574,3,3,7,13,0,26
User2005,4,6,1,14,0,25
User1702,0,1,3,21,0,25
User420,18,2,3,2,0,25
User592,3,3,2,17,0,25
User2844,0,12,2,10,1,25
User595,0,23,2,0,0,25
User202,24,0,1,0,0,25
User191,0,24,0,0,1,25
User2545,0,0,1,24,0,25
User1444,0,0,2,23,0,25
User4058,17,5,3,0,0,25
User3792,9,16,0,0,0,25
User868,0,14,2,2,7,25
User1709,5,6,0,14,0,25
User881,2,0,23,0,0,25
User1235,0,7,8,10,0,25
User247,0,4,10,11,0,25
User3350,0,13,0,7,5,25
User658,0,8,8,9,0,25
User3259,1,23,1,0,0,25
User1137,0,3,8,14,0,25
User982,0,4,16,5,0,25
User464,2,12,9,2,0,25
User2952,0,2,22,1,0,25
User1496,0,0,14,11,0,25
User1488,0,19,0,2,4,25
User929,5,5,9,6,0,25
User1800,3,8,12,2,0,25
User2997,6,1,1,17,0,25
User2386,0,2,3,20,0,25
User701,2,5,11,1,6,25
User5090,0,0,7,17,0,24
User1979,0,12,1,11,0,24
User4124,1,0,22,1,0,24
User817,0,3,7,14,0,24
User3,7,8,8,0,1,24
User129,6,3,5,10,0,24
User3797,0,18,5,0,1,24
User2261,2,11,5,6,0,24
User1705,8,5,3,8,0,24
User3970,3,8,13,0,0,24
User1466,2,0,13,9,0,24
User2609,3,13,4,4,0,24
User3293,0,4,14,6,0,24
User2135,15,5,4,0,0,24
User1541,0,19,3,1,1,24
User2144,1,8,12,2,1,24
User3665,0,5,18,1,0,24
User1072,5,14,3,2,0,24
User2106,1,19,1,0,3,24
User668,0,1,8,15,0,24
User905,0,14,0,10,0,24
User2052,0,0,14,10,0,24
User307,4,16,1,1,2,24
User2016,3,4,13,4,0,24
User1094,11,5,0,8,0,24
User392,0,2,6,16,0,24
User1389,9,10,0,4,1,24
User1683,0,7,9,6,2,24
User1729,7,8,6,3,0,24
User1024,0,13,5,5,1,24
User1660,1,21,1,1,0,24
User3834,0,1,10,12,0,23
User1210,4,10,4,5,0,23
User5881,0,23,0,0,0,23
User636,10,7,5,1,0,23
User428,0,16,3,2,2,23
User4339,0,23,0,0,0,23
User2118,23,0,0,0,0,23
User4326,0,23,0,0,0,23
User752,0,18,0,5,0,23
User378,0,3,10,10,0,23
User2600,0,23,0,0,0,23
User125,1,16,4,1,1,23
User389,0,2,6,15,0,23
User2777,6,7,10,0,0,23
User2778,0,2,13,8,0,23
User1877,1,9,13,0,0,23
User3582,0,0,0,23,0,23
User4617,0,16,7,0,0,23
User1469,1,1,7,14,0,23
User2573,0,9,7,7,0,23
User1516,1,1,0,21,0,23
User1248,0,2,3,18,0,23
User1531,13,0,0,10,0,23
User1316,0,13,0,10,0,23
User1230,0,17,6,0,0,23
User1774,6,3,5,9,0,23
User1548,4,2,2,15,0,23
User1966,0,23,0,0,0,23
User2337,5,10,1,7,0,23
User2396,0,13,9,1,0,23
User1100,0,23,0,0,0,23
User3530,0,0,0,22,0,22
User2987,0,0,15,7,0,22
User1983,4,17,1,0,0,22
User624,0,10,6,5,1,22
User630,1,6,14,1,0,22
User1617,0,0,16,6,0,22
User418,0,6,11,5,0,22
User1129,3,9,6,4,0,22
User4143,1,6,4,9,2,22
User1298,19,0,3,0,0,22
User902,1,20,1,0,0,22
User1317,4,4,4,10,0,22
User23,0,3,19,0,0,22
User5632,0,0,22,0,0,22
User3442,0,22,0,0,0,22
User4396,0,0,1,21,0,22
User1543,1,1,7,10,3,22
User2663,0,9,1,10,2,22
User2958,0,16,5,0,1,22
User143,0,0,0,0,22,22
User2050,0,5,10,7,0,22
User2576,1,7,9,5,0,22
User2804,0,1,16,5,0,22
User2574,1,3,0,18,0,22
User440,1,2,16,3,0,22
User3202,0,1,3,18,0,22
User3599,0,22,0,0,0,22
User1682,0,10,2,10,0,22
User820,0,0,9,13,0,22
User3184,0,16,4,1,0,21
User593,0,0,1,20,0,21
User1746,0,7,7,7,0,21
User793,3,3,3,12,0,21
User582,2,8,11,0,0,21
User1708,0,1,15,5,0,21
User3128,0,1,3,17,0,21
User2650,1,4,8,8,0,21
User2542,3,11,7,0,0,21
User2518,0,8,12,1,0,21
User3056,0,1,7,13,0,21
User2933,0,7,6,8,0,21
User268,0,15,0,6,0,21
User5113,1,1,19,0,0,21
User463,5,5,11,0,0,21
User2450,0,0,2,19,0,21
User2245,0,14,3,4,0,21
User1568,0,0,1,20,0,21
User2717,2,18,1,0,0,21
User1608,7,8,3,3,0,21
User1336,0,0,19,2,0,21
User756,7,6,4,4,0,21
User2860,0,0,17,4,0,21
User1323,0,18,0,0,3,21
User1870,0,2,15,4,0,21
User1722,1,12,3,4,1,21
User2847,0,0,9,12,0,21
User1303,7,1,5,8,0,21
User4315,0,17,1,3,0,21
User3290,2,17,2,0,0,21
User3249,0,12,2,7,0,21
User2042,0,17,3,1,0,21
User1408,4,3,2,12,0,21
User618,0,0,13,8,0,21
User3926,0,6,8,6,1,21
User2444,0,2,0,19,0,21
User2732,1,0,8,10,2,21
User808,4,9,7,0,1,21
User3718,0,3,7,11,0,21
User2823,0,11,4,6,0,21
User2333,0,1,2,18,0,21
User917,1,12,7,1,0,21
User4607,0,15,0,0,6,21
User3748,0,7,9,5,0,21
User1785,0,6,9,5,0,20
User2535,1,10,9,0,0,20
User2346,0,0,14,6,0,20
User1465,1,0,6,13,0,20
User634,2,2,9,6,1,20
User1965,0,3,13,4,0,20
User4261,2,14,3,0,1,20
User5722,0,20,0,0,0,20
User2473,13,4,3,0,0,20
User1433,4,0,16,0,0,20
User2486,0,11,4,5,0,20
User611,10,4,6,0,0,20
User919,1,7,0,12,0,20
User1597,7,4,7,0,2,20
User1834,0,0,6,14,0,20
User3207,17,0,2,1,0,20
User1065,0,0,18,2,0,20
User481,0,15,1,0,4,20
User4257,0,0,15,5,0,20
User2204,0,0,11,9,0,20
User835,0,12,8,0,0,20
User2034,4,13,2,1,0,20
User733,0,5,0,15,0,20
User4643,3,0,14,3,0,20
User1555,4,1,6,9,0,20
User800,3,15,1,1,0,20
User1828,10,0,3,7,0,20
User1928,0,2,17,1,0,20
User1921,1,17,1,1,0,20
User5212,0,17,3,0,0,20
User732,4,8,7,0,0,19
User1670,0,0,1,18,0,19
User901,4,0,7,8,0,19
User1050,11,1,6,0,1,19
User4208,4,12,3,0,0,19
User2532,0,10,9,0,0,19
User1001,12,2,5,0,0,19
User2122,0,6,13,0,0,19
User5106,2,17,0,0,0,19
User3057,0,3,7,9,0,19
User558,4,2,10,3,0,19
User1493,0,0,13,6,0,19
User1552,0,16,0,2,1,19
User754,0,12,2,5,0,19
User1345,0,6,4,9,0,19
User2675,0,2,9,8,0,19
User1727,0,0,0,19,0,19
User1969,0,11,5,3,0,19
User2021,0,0,0,19,0,19
User1403,10,4,2,1,2,19
User3255,0,19,0,0,0,19
User3815,0,13,6,0,0,19
User2249,6,12,0,1,0,19
User2412,3,4,8,4,0,19
User807,3,3,7,6,0,19
User3375,1,0,16,2,0,19
User1645,4,5,10,0,0,19
User421,0,1,1,17,0,19
User3674,0,17,2,0,0,19
User1716,11,4,2,2,0,19
User78,5,0,7,0,7,19
User587,15,2,2,0,0,19
User2102,0,0,1,18,0,19
User3828,6,4,0,9,0,19
User2855,0,4,12,3,0,19
User3281,1,5,9,4,0,19
User1611,0,2,16,1,0,19
User3957,1,0,14,4,0,19
User34,4,1,4,8,2,19
User5777,0,0,18,1,0,19
User3117,0,5,4,10,0,19
User1643,0,5,10,3,0,18
User386,0,3,6,9,0,18
User1612,10,5,2,1,0,18
User3506,0,0,3,15,0,18
User1211,1,8,3,6,0,18
User1964,2,12,0,0,4,18
User4903,0,13,5,0,0,18
User1539,3,8,3,4,0,18
User1931,2,6,3,7,0,18
User572,3,13,0,2,0,18
User4634,0,18,0,0,0,18
User333,0,0,11,7,0,18
User2148,2,5,7,4,0,18
User2098,0,0,4,14,0,18
User3048,0,0,17,1,0,18
User1371,4,8,3,3,0,18
User2543,2,8,6,2,0,18
User1013,2,0,3,12,1,18
User2405,0,1,17,0,0,18
User2867,7,7,2,2,0,18
User909,11,4,3,0,0,18
User3873,1,5,6,6,0,18
User737,4,14,0,0,0,18
User3081,0,13,5,0,0,18
User764,15,1,2,0,0,18
User223,0,12,3,0,3,18
User771,2,1,6,9,0,18
User1968,0,9,8,1,0,18
User872,0,9,4,5,0,18
User2925,0,0,12,6,0,18
User1666,0,0,9,9,0,18
User2915,0,0,6,12,0,18
User1671,0,13,1,0,4,18
User845,2,1,7,8,0,18
User2641,2,0,0,16,0,18
User2715,0,4,8,6,0,18
User1715,5,4,0,9,0,18
User852,7,2,5,4,0,18
User4227,2,15,1,0,0,18
User1695,0,0,18,0,0,18
User1898,0,6,5,6,1,18
User5096,0,11,7,0,0,18
User3667,4,5,5,4,0,18
User1114,4,9,0,5,0,18
User2335,0,7,0,0,10,17
User581,9,4,2,2,0,17
User2892,1,0,14,2,0,17
User2338,3,0,7,7,0,17
User153,0,0,15,2,0,17
User2983,10,4,2,1,0,17
User42,0,3,7,7,0,17
User4235,0,0,11,6,0,17
User1915,1,0,1,14,1,17
User1926,0,17,0,0,0,17
User4579,0,0,3,14,0,17
User2091,0,0,3,14,0,17
User4880,0,17,0,0,0,17
User2979,1,11,5,0,0,17
User1486,3,7,3,4,0,17
User4983,0,17,0,0,0,17
User942,0,11,4,2,0,17
User1765,1,2,5,9,0,17
User2089,2,2,6,7,0,17
User1086,3,12,0,2,0,17
User5214,0,8,9,0,0,17
User1428,0,7,6,3,1,17
User1798,0,2,3,12,0,17
User1772,0,1,0,16,0,17
User601,1,0,3,13,0,17
User5484,0,0,17,0,0,17
User5726,0,17,0,0,0,17
User980,0,17,0,0,0,17
User2152,0,2,4,11,0,17
User1885,1,15,1,0,0,17
User4511,11,6,0,0,0,17
User742,1,1,6,9,0,17
User168,0,4,1,12,0,17
User5618,0,3,14,0,0,17
User4967,0,4,9,4,0,17
User3785,0,16,1,0,0,17
User391,0,0,1,16,0,17
User2475,0,8,4,5,0,17
User1131,2,10,3,2,0,17
User922,0,4,3,10,0,17
User1862,0,0,1,16,0,17
User2875,0,17,0,0,0,17
User2517,1,5,1,10,0,17
User1610,0,6,6,5,0,17
User4356,13,4,0,0,0,17
User3365,0,0,0,17,0,17
User792,0,0,4,13,0,17
User4372,0,16,0,1,0,17
User4448,2,1,7,7,0,17
User1241,0,2,9,6,0,17
User508,1,13,3,0,0,17
User1899,0,0,13,3,0,16
User3609,0,0,11,5,0,16
User2763,0,6,3,7,0,16
User2180,0,2,11,3,0,16
User1051,6,5,2,3,0,16
User4881,14,2,0,0,0,16
User2110,0,7,4,5,0,16
User2526,5,0,3,8,0,16
User5963,8,6,2,0,0,16
User767,6,6,3,1,0,16
User885,3,3,3,7,0,16
User172,3,10,0,0,3,16
User1151,0,3,3,10,0,16
User2862,1,2,5,8,0,16
User3698,5,1,4,6,0,16
User1288,4,0,10,2,0,16
User3237,0,1,6,9,0,16
User4020,0,9,7,0,0,16
User4059,1,8,0,0,7,16
User679,1,1,7,7,0,16
User2982,0,0,1,15,0,16
User1788,0,3,10,3,0,16
User1857,14,2,0,0,0,16
User2754,0,3,12,1,0,16
User1935,2,1,3,10,0,16
User3309,0,1,4,11,0,16
User1854,0,8,7,1,0,16
User4200,0,0,11,5,0,16
User3430,10,0,1,5,0,16
User3918,0,1,9,6,0,16
User19,1,8,5,2,0,16
User3705,2,13,0,0,1,16
User543,1,2,13,0,0,16
User628,0,10,6,0,0,16
User995,1,0,8,7,0,16
User3030,0,1,8,7,0,16
User591,15,0,1,0,0,16
User1559,3,5,8,0,0,16
User3569,4,9,1,2,0,16
User2097,0,3,3,5,5,16
User4295,0,1,1,14,0,16
User4735,0,16,0,0,0,16
User1982,0,0,13,3,0,16
User1515,0,2,4,10,0,16
User750,4,1,11,0,0,16
User516,3,0,4,9,0,16
User2390,2,3,1,10,0,16
User2154,8,6,1,1,0,16
User1055,0,4,10,2,0,16
User2017,7,8,0,0,1,16
User1355,1,6,0,9,0,16
User914,0,3,13,0,0,16
User2430,0,9,5,2,0,16
User5389,0,0,15,0,0,15
User4229,0,8,4,1,2,15
User2901,0,0,0,15,0,15
User2111,0,0,4,11,0,15
User341,0,11,4,0,0,15
User1711,0,4,0,0,11,15
User3870,0,13,0,2,0,15
User2420,1,2,8,4,0,15
User3356,2,11,1,1,0,15
User1039,7,5,0,2,1,15
User1489,0,2,5,8,0,15
User3383,0,15,0,0,0,15
User3397,1,11,0,3,0,15
User1700,0,0,1,14,0,15
User596,4,7,0,0,4,15
User1474,0,8,0,7,0,15
User5471,0,15,0,0,0,15
User1118,1,8,4,1,1,15
User2528,0,7,2,6,0,15
User3072,10,2,3,0,0,15
User1864,0,9,2,4,0,15
User3066,0,0,6,9,0,15
User2320,0,0,8,7,0,15
User3050,0,0,0,15,0,15
User1297,1,9,1,4,0,15
User2678,1,14,0,0,0,15
User3042,0,1,6,8,0,15
User740,3,0,0,12,0,15
User4073,3,2,6,1,3,15
User1398,0,2,10,3,0,15
User3027,0,0,9,6,0,15
User3092,1,0,3,11,0,15
User3211,0,1,12,2,0,15
User2195,0,4,6,5,0,15
User2500,0,2,1,12,0,15
User2289,0,14,0,0,1,15
User3185,1,12,0,2,0,15
User1961,0,9,5,0,1,15
User1954,0,8,7,0,0,15
User1950,1,7,4,1,2,15
User1158,0,0,13,2,0,15
User1201,5,1,4,5,0,15
User4319,15,0,0,0,0,15
User3966,11,4,0,0,0,15
User2734,0,0,12,3,0,15
User2697,0,4,0,10,1,15
User3138,4,1,3,6,1,15
User1920,0,7,7,1,0,15
User1904,2,11,1,1,0,15
User973,1,4,10,0,0,15
User1321,0,2,10,3,0,15
User5275,0,14,1,0,0,15
User3939,0,0,12,3,0,15
User553,0,1,10,4,0,15
User3579,0,0,15,0,0,15
User1457,0,0,2,13,0,15
User59,3,3,8,0,0,14
User1912,0,11,1,2,0,14
User3124,2,1,5,5,1,14
User4040,0,1,12,1,0,14
User5086,3,1,6,2,2,14
User2743,0,12,1,1,0,14
User2903,0,3,8,3,0,14
User2745,0,0,11,3,0,14
User1265,2,9,2,1,0,14
User1266,1,2,11,0,0,14
User2171,0,5,1,8,0,14
User497,0,0,8,6,0,14
User2002,0,7,3,4,0,14
User3132,0,12,1,1,0,14
User639,3,0,1,10,0,14
User2114,6,6,0,2,0,14
User884,0,1,0,13,0,14
User883,11,1,0,2,0,14
User3005,1,2,6,5,0,14
User441,0,14,0,0,0,14
User2762,0,0,7,7,0,14
User2604,0,0,5,9,0,14
User5152,0,14,0,0,0,14
User1247,0,11,1,2,0,14
User1703,0,0,1,12,1,14
User3337,0,1,11,2,0,14
User5144,0,14,0,0,0,14
User79,0,7,7,0,0,14
User1960,5,5,4,0,0,14
User367,0,6,0,8,0,14
User2667,0,2,3,9,0,14
User1685,3,9,1,1,0,14
User1160,8,3,0,3,0,14
User4502,0,2,4,8,0,14
User605,0,1,5,8,0,14
User606,0,12,0,2,0,14
User2399,0,12,1,0,1,14
User250,3,10,0,0,1,14
User1655,8,6,0,0,0,14
User131,2,2,6,4,0,14
User4109,1,13,0,0,0,14
User1789,1,9,1,2,1,14
User1646,0,2,12,0,0,14
User5868,7,7,0,0,0,14
User3271,0,2,1,11,0,14
User1453,1,2,9,2,0,14
User1697,1,10,1,2,0,14
User3347,0,0,6,8,0,14
User1222,0,0,6,8,0,14
User622,5,2,3,4,0,14
User3064,0,11,0,3,0,14
User2187,0,1,1,12,0,14
User2946,0,0,13,1,0,14
User4868,0,5,1,8,0,14
User2676,7,5,1,1,0,14
User1527,0,1,4,8,1,14
User3039,0,0,7,7,0,14
User2945,0,1,6,7,0,14
User4664,0,14,0,0,0,14
User4447,0,2,7,5,0,14
User1535,0,13,1,0,0,14
User4569,0,0,13,1,0,14
User1831,0,13,0,1,0,14
User3393,0,0,14,0,0,14
User1540,0,8,4,2,0,14
User4572,0,0,0,14,0,14
User1104,0,0,14,0,0,14
User1832,0,0,7,7,0,14
User4633,0,13,1,0,0,14
User1738,0,1,7,5,1,14
User1822,1,9,0,4,0,14
User2053,2,6,0,6,0,14
User575,4,4,6,0,0,14
User1853,0,7,5,2,0,14
User3570,0,11,2,1,0,14
User2128,0,12,1,1,0,14
User2792,0,14,0,0,0,14
User1432,0,9,0,5,0,14
User1361,3,0,4,7,0,14
User724,0,0,5,8,0,13
User858,0,0,2,11,0,13
User3963,0,0,5,8,0,13
User1012,2,2,0,9,0,13
User4593,1,1,11,0,0,13
User4095,0,8,4,1,0,13
User3324,1,0,0,12,0,13
User4630,0,0,9,4,0,13
User4321,0,0,13,0,0,13
User152,0,5,1,7,0,13
User1174,0,7,2,2,2,13
User2260,3,4,4,2,0,13
User2476,2,0,1,10,0,13
User4328,0,0,8,5,0,13
User1192,0,12,1,0,0,13
User1639,4,3,2,4,0,13
User477,5,6,0,2,0,13
User3565,0,3,7,3,0,13
User1468,0,4,3,6,0,13
User5669,0,6,4,3,0,13
User2730,0,2,3,8,0,13
User2722,0,6,7,0,0,13
User3402,0,0,4,9,0,13
User2215,12,1,0,0,0,13
User1542,0,7,3,0,3,13
User2966,4,8,1,0,0,13
User1839,0,2,9,2,0,13
User2469,0,1,0,12,0,13
User1887,3,1,3,6,0,13
User1295,0,4,4,5,0,13
User960,0,1,5,7,0,13
User4197,3,9,0,1,0,13
User1719,5,6,2,0,0,13
User1561,0,0,10,3,0,13
User2344,0,1,3,9,0,13
User1868,0,0,12,1,0,13
User2530,0,11,2,0,0,13
User4150,0,12,0,1,0,13
User1797,0,13,0,0,0,13
User1574,0,13,0,0,0,13
User3417,0,0,3,10,0,13
User772,2,6,2,3,0,13
User1511,0,11,0,1,1,13
User1095,3,4,3,3,0,13
User557,0,9,4,0,0,13
User589,0,7,2,4,0,13
User2137,3,3,4,3,0,13
User2353,0,5,8,0,0,13
User3251,0,0,3,10,0,13
User1106,0,1,11,1,0,13
User3283,0,0,13,0,0,13
User1995,0,0,7,6,0,13
User1992,0,1,0,12,0,13
User4438,0,11,1,0,0,12
User1681,1,2,0,9,0,12
User1867,7,3,2,0,0,12
User1914,3,1,2,6,0,12
User1017,2,2,8,0,0,12
User336,0,2,6,3,1,12
User3709,0,1,8,3,0,12
User935,0,4,8,0,0,12
User3779,1,8,3,0,0,12
User3829,0,3,5,4,0,12
User1710,0,0,2,10,0,12
User578,3,4,5,0,0,12
User5238,0,0,12,0,0,12
User2647,0,12,0,0,0,12
User2643,1,2,3,6,0,12
User2374,0,0,0,12,0,12
User4352,0,2,7,3,0,12
User2797,0,1,8,3,0,12
User2662,5,0,5,2,0,12
User551,0,12,0,0,0,12
User1942,0,1,1,10,0,12
User499,0,11,0,1,0,12
User5,2,10,0,0,0,12
User2705,1,3,8,0,0,12
User561,0,10,2,0,0,12
User906,0,6,5,1,0,12
User3798,0,0,0,12,0,12
User2695,0,8,0,4,0,12
User1876,1,7,4,0,0,12
User2064,0,0,0,12,0,12
User1874,0,6,5,1,0,12
User2382,1,2,0,9,0,12
User5261,0,8,0,0,4,12
User2601,0,3,2,7,0,12
User3000,0,8,0,4,0,12
User844,0,2,8,2,0,12
User2524,0,10,0,2,0,12
User1119,0,0,1,11,0,12
User3215,1,0,11,0,0,12
User3647,0,9,3,0,0,12
User5162,0,11,1,0,0,12
User3405,0,0,2,10,0,12
User1278,1,5,6,0,0,12
User1277,1,11,0,0,0,12
User2597,0,0,12,0,0,12
User867,0,0,6,6,0,12
User1276,1,7,2,2,0,12
User4130,0,11,1,0,0,12
User3121,3,7,2,0,0,12
User1254,6,1,0,5,0,12
User1253,0,0,9,3,0,12
User1310,0,8,0,4,0,12
User2581,0,6,0,4,2,12
User382,0,1,6,5,0,12
User1342,0,2,2,8,0,12
User3022,0,3,4,5,0,12
User1459,0,0,10,2,0,12
User4170,0,7,1,4,0,12
User3399,0,0,3,9,0,12
User2572,0,10,1,1,0,12
User3041,0,4,8,0,0,12
User3225,5,1,1,3,2,12
User1501,3,6,1,1,1,12
User3993,2,2,4,4,0,12
User1506,0,0,0,0,12,12
User3058,0,0,3,9,0,12
User1352,1,1,3,7,0,12
User2956,0,11,0,0,1,12
User4204,0,0,7,5,0,12
User4690,0,0,0,12,0,12
User2919,0,3,1,8,0,12
User775,0,1,0,11,0,12
User1040,0,2,7,3,0,12
User1163,9,3,0,0,0,12
User4838,0,12,0,0,0,12
User2886,0,0,12,0,0,12
User2270,0,5,5,2,0,12
User138,0,1,5,0,6,12
User2897,0,8,3,1,0,12
User796,1,0,2,9,0,12
User4033,0,6,6,0,0,12
User2352,1,1,9,1,0,12
User2870,0,0,10,2,0,12
User1156,1,0,9,2,0,12
User1231,3,2,3,4,0,12
User2438,1,4,4,3,0,12
User2113,0,7,1,4,0,12
User2713,0,1,0,10,0,11
User3559,3,8,0,0,0,11
User5671,0,4,4,3,0,11
User3055,0,0,1,10,0,11
User3968,0,10,1,0,0,11
User2560,0,7,1,3,0,11
User3969,1,9,0,0,1,11
User2682,0,1,2,8,0,11
User4807,0,11,0,0,0,11
User4399,0,6,5,0,0,11
User1096,0,11,0,0,0,11
User1186,0,0,2,9,0,11
User205,2,8,0,0,1,11
User2788,1,0,1,9,0,11
User3771,3,6,0,0,2,11
User1833,0,5,0,6,0,11
User3038,0,3,8,0,0,11
User3996,0,10,0,1,0,11
User1391,0,0,4,7,0,11
User2012,3,7,1,0,0,11
User5623,0,0,5,6,0,11
User2332,0,9,2,0,0,11
User2197,0,0,0,11,0,11
User1175,0,3,0,5,3,11
User1815,2,5,2,0,2,11
User2555,0,8,1,2,0,11
User1811,0,0,10,1,0,11
User3415,0,1,8,2,0,11
User3839,0,4,3,4,0,11
User283,0,8,1,2,0,11
User149,2,0,5,4,0,11
User4029,0,7,3,1,0,11
User1916,2,9,0,0,0,11
User2408,0,0,0,11,0,11
User3122,0,2,5,4,0,11
User5813,0,7,2,2,0,11
User932,1,9,1,0,0,11
User3800,0,8,3,0,0,11
User4086,6,0,4,1,0,11
User1229,0,0,0,11,0,11
User2751,0,1,3,7,0,11
User2479,0,0,0,11,0,11
User3105,3,7,0,0,1,11
User2521,0,0,1,10,0,11
User798,8,1,0,2,0,11
User2483,0,7,0,4,0,11
User2537,0,0,2,9,0,11
User2465,3,3,2,3,0,11
User5068,0,1,0,10,0,11
User4786,0,0,0,9,2,11
User1879,0,7,0,4,0,11
User280,0,0,0,0,11,11
User3147,8,3,0,0,0,11
User3440,0,1,5,5,0,11
User961,1,0,2,8,0,11
User2226,3,0,7,1,0,11
User1329,0,9,2,0,0,11
User3419,6,5,0,0,0,11
User376,0,0,3,8,0,11
User5350,0,1,10,0,0,11
User1347,0,3,4,4,0,11
User3856,0,5,1,5,0,11
User4491,0,0,10,1,0,11
User3566,0,5,2,4,0,11
User4281,0,5,6,0,0,11
User225,3,5,3,0,0,11
User5537,0,4,4,3,0,11
User2445,0,3,3,5,0,11
User590,7,0,3,1,0,11
User2161,0,6,0,5,0,11
User2968,0,6,2,3,0,11
User4060,8,0,3,0,0,11
User22,2,6,0,1,2,11
User415,0,3,1,0,7,11
User1570,0,2,6,3,0,11
User2893,2,0,5,4,0,11
User1002,1,2,1,7,0,11
User1753,0,0,8,3,0,11
User662,0,6,5,0,0,11
User3354,0,3,1,7,0,11
User1750,1,7,3,0,0,11
User1749,0,0,2,9,0,11
User3254,0,0,0,11,0,11
User2939,0,0,5,6,0,11
User2563,0,1,8,2,0,11
User1082,0,6,5,0,0,11
User569,0,10,1,0,0,11
User1456,1,1,4,5,0,11
User3752,0,0,11,0,0,11
User2168,0,0,0,11,0,11
User3592,0,3,4,4,0,11
User1463,2,1,6,1,1,11
User1693,0,10,0,1,0,11
User238,4,1,3,1,2,11
User2173,0,0,9,2,0,11
User2363,0,11,0,0,0,11
User2857,0,6,4,0,0,10
User3724,0,10,0,0,0,10
User2248,0,1,2,7,0,10
User1166,1,5,3,0,1,10
User3501,0,4,6,0,0,10
User3112,0,0,0,10,0,10
User408,0,0,4,6,0,10
User4564,0,10,0,0,0,10
User4337,3,7,0,0,0,10
User2240,1,3,6,0,0,10
User2075,2,0,7,1,0,10
User468,0,2,1,6,1,10
User1048,0,0,0,10,0,10
User231,0,9,1,0,0,10
User3335,0,6,4,0,0,10
User608,0,0,1,9,0,10
User1688,0,6,1,2,1,10
User2496,0,1,3,5,1,10
User957,2,5,2,1,0,10
User656,7,1,0,1,1,10
User4139,0,0,4,6,0,10
User4449,0,10,0,0,0,10
User2311,0,1,0,9,0,10
User4820,0,0,9,1,0,10
User4496,0,1,0,9,0,10
User2499,0,8,0,0,2,10
User4904,0,4,4,2,0,10
User1250,0,1,5,4,0,10
User3130,0,6,4,0,0,10
User2506,0,0,9,1,0,10
User891,0,6,0,4,0,10
User1029,5,2,2,0,1,10
User2367,0,4,5,1,0,10
User2503,0,2,3,5,0,10
User335,0,0,3,6,1,10
User295,0,0,2,8,0,10
User3491,0,9,1,0,0,10
User2424,0,3,0,7,0,10
User3140,0,0,10,0,0,10
User615,4,6,0,0,0,10
User4507,0,0,10,0,0,10
User1218,0,2,0,8,0,10
User1884,0,8,0,2,0,10
User2849,1,6,2,1,0,10
User1008,6,4,0,0,0,10
User3135,0,5,5,0,0,10
User1227,0,1,9,0,0,10
User4014,1,5,2,0,2,10
User635,0,5,0,5,0,10
User1232,0,2,0,7,1,10
User4521,1,0,9,0,0,10
User1580,2,0,7,1,0,10
User299,1,8,0,0,1,10
User707,5,0,4,1,0,10
User2384,3,2,0,5,0,10
User393,0,1,4,5,0,10
User3551,0,0,9,1,0,10
User1074,2,0,6,2,0,10
User751,3,3,4,0,0,10
User3924,1,8,0,0,1,10
User5978,0,10,0,0,0,10
User2157,2,0,8,0,0,10
User4408,0,4,0,6,0,10
User5472,0,10,0,0,0,10
User678,0,0,3,7,0,10
User2165,1,9,0,0,0,10
User2207,0,0,5,5,0,10
User2205,0,2,7,1,0,10
User3593,5,3,1,0,1,10
User3346,0,5,4,1,0,10
User5029,0,9,1,0,0,10
User1678,0,4,3,3,0,10
User2414,0,1,4,5,0,10
User4644,2,7,0,1,0,10
User4615,0,10,0,0,0,10
User546,2,0,7,1,0,10
User2793,0,2,7,1,0,10
User5711,0,6,1,2,1,10
User1420,0,8,0,2,0,10
User4625,0,9,1,0,0,10
User4024,0,0,9,1,0,10
User4627,0,7,3,0,0,10
User2036,0,1,1,8,0,10
User2182,6,0,0,4,0,10
User3294,0,0,6,4,0,10
User864,0,0,3,7,0,10
User3544,0,3,6,1,0,10
User2464,10,0,0,0,0,10
User5277,0,9,0,1,0,10
User1755,0,2,1,2,5,10
User1341,0,0,0,10,0,10
User1521,1,3,1,5,0,10
User666,0,1,4,5,0,10
User4383,3,5,2,0,0,10
User3793,1,6,3,0,0,10
User1332,2,7,1,0,0,10
User1069,0,3,3,4,0,10
User1311,0,1,9,0,0,10
User963,0,0,8,2,0,10
User768,0,1,1,8,0,10
User4310,8,2,0,0,0,10
User3247,1,5,3,1,0,10
User1301,0,2,1,7,0,10
User2377,0,1,0,8,0,9
User2711,0,1,2,6,0,9
User2685,6,0,2,1,0,9
User2041,0,0,9,0,0,9
User2213,0,0,9,0,0,9
User2174,1,6,1,1,0,9
User2442,0,2,7,0,0,9
User2364,0,5,2,2,0,9
User2139,0,0,1,8,0,9
User5327,0,9,0,0,0,9
User2082,0,0,4,5,0,9
User2692,1,0,6,2,0,9
User2684,0,9,0,0,0,9
User2677,0,1,0,8,0,9
User2547,0,1,4,4,0,9
User2149,8,1,0,0,0,9
User2115,0,4,3,2,0,9
User4123,0,9,0,0,0,9
User2305,0,7,0,2,0,9
User5269,0,9,0,0,0,9
User1985,2,1,2,4,0,9
User2153,1,4,0,1,3,9
User4050,0,0,1,8,0,9
User2217,8,0,0,1,0,9
User2626,0,1,5,3,0,9
User2067,0,7,0,2,0,9
User317,2,3,2,1,1,9
User2295,0,5,3,1,0,9
User2511,0,6,1,2,0,9
User2519,1,1,4,3,0,9
User38,5,1,0,3,0,9
User4000,9,0,0,0,0,9
User2661,0,1,2,6,0,9
User3326,0,0,5,4,0,9
User1967,0,5,3,1,0,9
User1344,1,1,1,6,0,9
User5986,0,0,9,0,0,9
User2832,0,6,2,1,0,9
User1281,2,1,5,1,0,9
User1273,1,0,8,0,0,9
User1764,1,4,2,1,1,9
User1267,0,0,4,5,0,9
User3502,2,4,3,0,0,9
User790,0,1,3,5,0,9
User3750,1,3,3,1,1,9
User4769,0,0,8,1,0,9
User4770,0,6,2,1,0,9
User1219,1,1,4,3,0,9
User3485,1,5,2,1,0,9
User1801,0,8,1,0,0,9
User3474,0,0,4,5,0,9
User1814,0,7,0,0,2,9
User4809,0,6,2,1,0,9
User1181,0,3,1,2,3,9
User1133,0,5,1,3,0,9
User3209,0,0,8,1,0,9
User3210,0,9,0,0,0,9
User3538,0,1,1,7,0,9
User5208,0,9,0,0,0,9
User3212,2,0,3,4,0,9
User3046,0,6,3,0,0,9
User2926,0,7,2,0,0,9
User648,0,2,5,2,0,9
User657,0,0,2,7,0,9
User3670,0,3,3,3,0,9
User2951,5,0,3,1,0,9
User3634,0,4,3,2,0,9
User629,1,5,3,0,0,9
User82,0,5,4,0,0,9
User673,0,0,8,1,0,9
User3611,0,9,0,0,0,9
User685,0,8,0,0,1,9
User3596,0,0,2,7,0,9
User1454,1,6,0,1,1,9
User4623,0,8,1,0,0,9
User708,1,0,0,8,0,9
User2869,2,7,0,0,0,9
User719,6,0,3,0,0,9
User1415,2,7,0,0,0,9
User4481,1,5,0,3,0,9
User1717,1,5,0,3,0,9
User2848,0,0,6,3,0,9
User1126,1,0,3,5,0,9
User1781,1,2,6,0,0,9
User1572,0,4,4,1,0,9
User4905,0,9,0,0,0,9
User4894,0,7,2,0,0,9
User3253,3,3,3,0,0,9
User3334,3,1,2,3,0,9
User1944,0,8,1,0,0,9
User2756,3,4,0,2,0,9
User3315,0,3,0,6,0,9
User1938,2,0,7,0,0,9
User2759,0,9,0,0,0,9
User3269,0,2,5,2,0,9
User3808,0,0,9,0,0,9
User921,0,0,4,5,0,9
User2744,1,6,1,0,1,9
User1120,3,0,6,0,0,9
User1009,1,8,0,0,0,9
User859,0,2,5,2,0,9
User915,0,5,3,1,0,9
User933,0,2,4,3,0,9
User4984,0,1,0,8,0,9
User5469,0,6,2,1,0,9
User1850,0,0,5,4,0,9
User847,0,1,3,5,0,9
User3416,0,1,6,2,0,9
User1534,0,2,0,6,0,8
User3306,0,2,6,0,0,8
User5411,0,6,2,0,0,8
User3013,1,0,4,3,0,8
User4185,0,2,5,1,0,8
User705,0,0,0,8,0,8
User4949,1,6,1,0,0,8
User3344,2,5,0,1,0,8
User3571,8,0,0,0,0,8
User1458,1,4,3,0,0,8
User716,0,1,2,5,0,8
User4632,0,0,8,0,0,8
User2188,0,1,2,5,0,8
User3942,0,5,3,0,0,8
User145,0,0,0,8,0,8
User2986,3,1,4,0,0,8
User3338,0,3,4,1,0,8
User4969,0,8,0,0,0,8
User3646,0,0,4,4,0,8
User928,1,5,2,0,0,8
User2937,0,5,0,3,0,8
User2587,1,5,0,2,0,8
User4215,6,0,0,2,0,8
User1550,3,0,1,4,0,8
User2954,0,0,0,8,0,8
User989,1,7,0,0,0,8
User2388,0,1,4,3,0,8
User2155,0,0,1,7,0,8
User4571,0,8,0,0,0,8
User2595,7,0,1,0,0,8
User2974,0,0,0,8,0,8
User2598,0,2,4,2,0,8
User651,0,0,8,0,0,8
User3633,6,2,0,0,0,8
User842,0,2,1,5,0,8
User1413,0,0,0,8,0,8
User997,0,0,1,7,0,8
User5392,0,2,4,2,0,8
User3125,0,0,2,6,0,8
User2930,8,0,0,0,0,8
User4119,0,6,0,2,0,8
User3964,0,3,0,2,3,8
User1080,0,2,2,4,0,8
User3239,0,1,0,7,0,8
User3233,0,2,2,4,0,8
User3227,0,8,0,0,0,8
User2504,0,8,0,0,0,8
User4796,0,0,7,1,0,8
User3187,0,1,1,6,0,8
User1159,0,7,1,0,0,8
User3191,1,6,1,0,0,8
User2481,0,0,7,1,0,8
User2480,2,3,3,0,0,8
User3429,0,0,8,0,0,8
User2456,0,2,5,1,0,8
User3221,0,2,1,5,0,8
User2247,0,3,0,4,1,8
User781,0,7,1,0,0,8
User2440,0,0,8,0,0,8
User2429,1,1,3,3,0,8
User1412,0,0,4,4,0,8
User1020,4,1,2,0,1,8
User4655,0,8,0,0,0,8
User1404,0,1,5,2,0,8
User4663,0,5,3,0,0,8
User4668,4,1,0,3,0,8
User739,8,0,0,0,0,8
User3274,0,8,0,0,0,8
User893,0,1,4,3,0,8
User1271,2,2,4,0,0,8
User3078,0,0,6,2,0,8
User2358,0,4,4,0,0,8
User343,0,0,2,6,0,8
User3089,0,0,3,5,0,8
User4741,0,8,0,0,0,8
User4144,1,2,0,0,5,8
User5559,0,8,0,0,0,8
User3261,0,1,7,0,0,8
User726,0,4,0,4,0,8
User4181,0,2,5,1,0,8
User2809,2,5,1,0,0,8
User2624,0,6,2,0,0,8
User3862,0,3,5,0,0,8
User4283,0,5,2,1,0,8
User3744,3,3,2,0,0,8
User2824,0,6,2,0,0,8
User2826,2,2,3,1,0,8
User2660,0,0,7,1,0,8
User2833,2,1,4,1,0,8
User2068,0,7,0,1,0,8
User1689,0,1,4,3,0,8
User2642,0,0,1,7,0,8
User2639,0,0,1,7,0,8
User3702,0,0,7,1,0,8
User4505,2,1,0,5,0,8
User1648,0,1,4,0,3,8
User5432,1,2,5,0,0,8
User2803,0,0,7,1,0,8
User555,1,5,1,0,1,8
User1820,1,7,0,0,0,8
User2000,0,0,3,5,0,8
User2710,0,0,1,7,0,8
User1975,0,3,3,2,0,8
User2739,0,0,3,5,0,8
User1927,1,0,0,7,0,8
User1986,2,5,1,0,0,8
User5771,1,7,0,0,0,8
User3848,0,7,1,0,0,8
User2027,0,0,0,8,0,8
User503,1,6,1,0,0,8
User459,0,6,2,0,0,8
User5266,1,7,0,0,0,8
User1848,0,6,1,1,0,8
User453,4,2,2,0,0,8
User3854,0,2,5,1,0,8
User3684,0,5,2,1,0,8
User194,8,0,0,0,0,8
User2612,0,5,0,0,3,8
User2899,0,1,7,0,0,8
User2610,5,0,2,0,1,8
User1600,0,0,6,2,0,8
User1924,0,2,0,5,0,7
User1778,0,6,0,1,0,7
User4917,7,0,0,0,0,7
User1824,1,3,2,1,0,7
User2908,0,0,7,0,0,7
User4297,0,0,1,6,0,7
User4530,0,0,5,2,0,7
User822,0,4,1,1,1,7
User4818,0,3,4,0,0,7
User4824,0,5,1,1,0,7
User495,0,2,0,0,5,7
User2492,0,3,3,1,0,7
User3175,1,4,2,0,0,7
User827,0,6,1,0,0,7
User3180,0,0,4,3,0,7
User445,1,3,2,1,0,7
User4094,0,2,3,2,0,7
User1825,3,1,0,0,3,7
User248,0,7,0,0,0,7
User2746,0,0,6,1,0,7
User2935,0,6,1,0,0,7
User3776,0,7,0,0,0,7
User4434,0,0,3,0,4,7
User1244,0,3,4,0,0,7
User3958,0,3,4,0,0,7
User4566,0,4,2,1,0,7
User3498,0,4,2,0,1,7
User3804,0,0,0,7,0,7
User146,0,1,0,4,2,7
User1783,0,6,0,1,0,7
User1603,1,2,3,1,0,7
User1925,0,0,4,3,0,7
User1223,0,0,7,0,0,7
User2929,0,2,2,3,0,7
User2696,0,0,3,4,0,7
User1917,1,2,4,0,0,7
User4787,0,1,6,0,0,7
User3364,0,0,1,6,0,7
User3368,0,1,1,5,0,7
User4092,3,4,0,0,0,7
User3172,0,0,1,6,0,7
User4282,0,0,7,0,0,7
User3411,0,5,1,0,1,7
User2437,0,4,3,0,0,7
User5516,0,7,0,0,0,7
User2457,0,0,3,4,0,7
User653,0,2,1,4,0,7
User4393,2,5,0,0,0,7
User1102,0,6,1,0,0,7
User848,0,0,1,6,0,7
User2328,0,7,0,0,0,7
User2330,1,6,0,0,0,7
User3975,0,0,5,2,0,7
User4871,0,5,0,2,0,7
User2934,0,7,0,0,0,7
User1047,0,2,3,2,0,7
User4878,0,5,2,0,0,7
User2001,0,3,2,0,2,7
User4071,0,0,1,6,0,7
User3849,0,0,7,0,0,7
User3245,2,0,1,4,0,7
User1891,0,3,1,3,0,7
User3787,0,2,1,4,0,7
User3662,1,0,6,0,0,7
User5814,0,7,0,0,0,7
User2431,0,0,5,2,0,7
User2482,0,2,2,3,0,7
User4299,0,3,0,4,0,7
User2025,0,1,3,3,0,7
User1143,5,2,0,0,0,7
User1142,0,7,0,0,0,7
User4845,2,5,0,0,0,7
User3845,2,1,3,1,0,7
User2306,0,0,2,5,0,7
User1134,0,1,4,1,1,7
User1838,0,0,4,3,0,7
User4301,0,0,1,6,0,7
User3378,0,0,1,5,1,7
User3384,0,7,0,0,0,7
User1844,0,1,3,3,0,7
User3426,0,3,1,3,0,7
User301,0,6,0,0,1,7
User2357,0,1,5,1,0,7
User1776,0,2,4,1,0,7
User3115,0,7,0,0,0,7
User473,0,0,5,2,0,7
User3835,0,0,2,5,0,7
User2081,0,3,4,0,0,7
User718,0,0,4,3,0,7
User2080,0,3,3,1,0,7
User1675,0,0,0,7,0,7
User424,4,0,2,1,0,7
User4642,0,0,0,7,0,7
User1577,0,1,0,6,0,7
User667,0,6,0,1,0,7
User4251,2,0,0,5,0,7
User1627,2,2,2,0,1,7
User2644,0,0,2,5,0,7
User4645,0,1,5,1,0,7
User3722,0,5,1,1,0,7
User4266,5,2,0,0,0,7
User2387,0,2,4,1,0,7
User1759,0,2,1,4,0,7
User4353,0,7,0,0,0,7
User1668,0,7,0,0,0,7
User2723,0,1,1,5,0,7
User5751,0,2,5,0,0,7
User1505,2,0,0,0,5,7
User2623,0,2,4,0,1,7
User3610,1,5,1,0,0,7
User5153,0,0,7,0,0,7
User161,3,3,1,0,0,7
User2963,0,6,0,1,0,7
User1957,0,7,0,0,0,7
User4249,0,7,0,0,0,7
User1460,0,0,4,3,0,7
User1955,2,2,3,0,0,7
User3906,0,7,0,0,0,7
User5539,0,0,0,7,0,7
User941,2,2,1,2,0,7
User1449,0,0,2,5,0,7
User2397,0,1,6,0,0,7
User3583,0,5,1,0,1,7
User4038,0,0,5,2,0,7
User3323,0,0,3,4,0,7
User670,0,0,1,6,0,7
User1382,1,6,0,0,0,7
User1880,0,2,1,4,0,7
User4456,0,7,0,0,0,7
User1565,0,3,2,2,0,7
User273,0,6,0,1,0,7
User3525,1,3,2,1,0,7
User5833,0,0,0,7,0,7
User664,4,3,0,0,0,7
User435,0,4,0,3,0,7
User5119,0,7,0,0,0,7
User1313,0,2,0,5,0,7
User2902,0,0,4,3,0,7
User1756,1,0,0,6,0,7
User2828,0,0,7,0,0,7
User5795,0,7,0,0,0,7
User2378,0,4,2,1,0,7
User3093,1,0,2,4,0,7
User2229,0,1,5,1,0,7
User3528,0,5,0,2,0,7
User1275,0,1,1,5,0,7
User766,1,0,4,1,1,7
User3307,0,1,6,0,0,7
User5344,0,7,0,0,0,7
User4686,0,0,3,4,0,7
User969,0,4,2,1,0,7
User5981,1,5,0,0,1,7
User5734,0,0,7,0,0,7
User586,1,6,0,0,0,7
User2536,6,0,0,1,0,7
User5112,4,2,0,0,1,7
User3069,0,1,1,5,0,7
User3073,0,1,5,1,0,7
User4028,0,6,1,0,0,7
User4727,0,1,3,3,0,7
User3795,1,0,5,0,0,6
User2599,0,2,1,3,0,6
User3304,0,6,0,0,0,6
User3802,1,3,0,1,1,6
User3830,0,1,1,4,0,6
User5824,0,4,0,2,0,6
User3387,1,3,2,0,0,6
User3651,0,0,3,3,0,6
User5642,0,0,2,4,0,6
User3331,0,6,0,0,0,6
User3275,0,5,1,0,0,6
User3318,0,3,2,1,0,6
User2747,0,5,1,0,0,6
User2694,0,0,5,1,0,6
User2699,0,0,6,0,0,6
User5466,0,0,6,0,0,6
User2413,0,0,0,6,0,6
User5626,0,1,2,3,0,6
User3616,2,0,3,1,0,6
User3244,0,1,1,4,0,6
User2446,0,5,0,1,0,6
User2816,0,5,1,0,0,6
User3110,3,0,1,2,0,6
User5561,0,0,1,5,0,6
User3515,0,0,6,0,0,6
User2827,0,6,0,0,0,6
User3522,0,3,3,0,0,6
User2836,1,3,0,2,0,6
User5702,0,0,6,0,0,6
User3061,6,0,0,0,0,6
User3553,0,0,6,0,0,6
User2842,5,1,0,0,0,6
User3563,0,0,2,2,2,6
User3033,0,3,3,0,0,6
User5750,3,0,3,0,0,6
User2548,0,3,3,0,0,6
User3947,0,0,1,5,0,6
User3020,0,1,1,4,0,6
User3941,0,0,1,5,0,6
User3572,0,2,1,3,0,6
User937,0,2,3,1,0,6
User243,2,3,0,1,0,6
User5438,1,3,2,0,0,6
User2873,0,6,0,0,0,6
User2880,0,2,4,0,0,6
User2566,0,2,0,4,0,6
User3681,0,0,6,0,0,6
User2991,0,6,0,0,0,6
User3120,0,5,0,1,0,6
User3499,0,6,0,0,0,6
User282,0,4,2,0,0,6
User3198,0,0,1,5,0,6
User3243,2,0,0,4,0,6
User2687,0,3,0,3,0,6
User2920,0,0,1,5,0,6
User5597,0,0,6,0,0,6
User113,0,0,0,6,0,6
User2917,6,0,0,0,0,6
User2767,0,0,0,6,0,6
User3425,0,1,5,0,0,6
User3980,1,0,4,1,0,6
User2772,0,6,0,0,0,6
User2775,0,4,0,2,0,6
User3431,0,5,1,0,0,6
User3437,0,6,0,0,0,6
User2590,0,5,0,1,0,6
User2488,0,0,3,3,0,6
User5401,0,4,1,1,0,6
User3162,0,1,4,1,0,6
User3465,0,0,5,1,0,6
User3467,0,0,6,0,0,6
User3476,0,0,4,2,0,6
User3480,3,0,3,0,0,6
User2505,0,6,0,0,0,6
User3149,1,2,1,2,0,6
User2507,0,5,0,1,0,6
User3148,0,1,5,0,0,6
User3763,2,0,4,0,0,6
User2927,0,0,3,3,0,6
User4981,0,0,2,4,0,6
User1674,0,2,1,3,0,6
User2251,0,1,0,5,0,6
User1315,0,2,1,3,0,6
User4720,0,6,0,0,0,6
User4718,0,0,6,0,0,6
User4482,0,0,2,4,0,6
User4483,0,0,6,0,0,6
User5111,0,6,0,0,0,6
User2253,0,0,1,5,0,6
User4688,0,2,3,1,0,6
User4784,0,0,0,6,0,6
User2235,0,0,4,2,0,6
User1364,0,0,1,5,0,6
User1366,0,1,1,4,0,6
User4484,0,5,1,0,0,6
User5124,0,5,0,1,0,6
User1370,0,0,3,3,0,6
User4670,0,0,0,6,0,6
User763,3,0,2,1,0,6
User1724,0,3,2,1,0,6
User4469,5,1,0,0,0,6
User1289,0,0,4,2,0,6
User4445,0,2,4,0,0,6
User4446,0,4,1,1,0,6
User1251,0,2,3,1,0,6
User2293,0,2,4,0,0,6
User1252,0,0,2,4,0,6
User4096,0,6,0,0,0,6
User1742,0,0,1,5,0,6
User4749,0,0,0,6,0,6
User5088,0,0,6,0,0,6
User4466,0,6,0,0,0,6
User4106,0,5,1,0,0,6
User4743,1,4,1,0,0,6
User2277,0,0,1,5,0,6
User1279,0,5,1,0,0,6
User4742,2,3,0,0,1,6
User4661,0,1,5,0,0,6
User4660,0,0,4,2,0,6
User5858,6,0,0,0,0,6
User1473,1,2,1,2,0,6
User686,0,2,0,1,3,6
User684,0,4,1,1,0,6
User1599,0,2,1,1,2,6
User1485,0,2,1,3,0,6
User2169,0,6,0,0,0,6
User1494,0,0,0,6,0,6
User2127,0,0,3,0,3,6
User144,0,0,1,5,0,6
User2160,0,0,2,4,0,6
User4594,0,0,6,0,0,6
User2134,0,1,3,2,0,6
User1586,1,2,2,0,1,6
User1518,0,2,0,4,0,6
User1576,1,1,2,2,0,6
User5165,0,0,5,1,0,6
User2175,1,4,1,0,0,6
User4184,0,5,1,0,0,6
User1414,0,0,4,2,0,6
User4609,1,5,0,0,0,6
User4518,0,0,2,4,0,6
User1416,0,0,3,3,0,6
User1422,6,0,0,0,0,6
User1649,0,1,1,0,4,6
User704,0,0,2,4,0,6
User4171,0,0,1,5,0,6
User5861,1,4,1,0,0,6
User1441,4,0,2,0,0,6
User1446,0,1,4,1,0,6
User4535,0,0,6,0,0,6
User1620,2,0,2,2,0,6
User696,0,0,0,6,0,6
User1613,1,4,1,0,0,6
User4179,0,0,5,1,0,6
User4543,0,2,2,2,0,6
User802,1,0,3,2,0,6
User4458,0,6,0,0,0,6
User4260,0,0,3,3,0,6
User2366,0,1,0,5,0,6
User2058,0,0,0,6,0,6
User344,0,0,2,4,0,6
User5032,0,4,0,2,0,6
User5887,0,2,3,1,0,6
User1846,0,2,1,3,0,6
User5367,0,5,1,0,0,6
User2349,0,3,2,1,0,6
User1895,0,0,2,4,0,6
User1059,0,0,2,4,0,6
User2355,0,0,0,6,0,6
User887,0,2,1,1,2,6
User2361,0,1,0,5,0,6
User1033,5,1,0,0,0,6
User846,0,0,5,1,0,6
User4360,0,5,0,0,1,6
User898,0,0,6,0,0,6
User2372,0,1,0,5,0,6
User4946,0,0,1,3,2,6
User4948,3,3,0,0,0,6
User469,0,5,0,0,1,6
User1971,0,3,3,0,0,6
User1972,0,0,3,3,0,6
User4332,0,2,2,2,0,6
User2393,0,0,4,2,0,6
User951,0,0,3,3,0,6
User1978,0,0,2,4,0,6
User4869,0,4,2,0,0,6
User2343,3,0,1,2,0,6
User1829,0,0,2,4,0,6
User2061,1,1,4,0,0,6
User825,0,3,3,0,0,6
User1128,0,0,5,1,0,6
User4432,1,0,4,1,0,6
User1148,0,0,6,0,0,6
User1773,0,0,6,0,0,6
User4834,0,0,6,0,0,6
User1532,4,0,0,1,0,5
User2837,0,0,0,5,0,5
User1605,0,1,2,2,0,5
User484,3,0,0,2,0,5
User3816,3,2,0,0,0,5
User5924,0,4,1,0,0,5
User3728,0,0,0,5,0,5
User2727,1,0,1,3,0,5
User4467,0,5,0,0,0,5
User4345,0,0,5,0,0,5
User1601,0,1,2,2,0,5
User3729,1,4,0,0,0,5
User1951,1,0,4,0,0,5
User1952,0,0,5,0,0,5
User1794,0,2,1,2,0,5
User4555,0,0,0,5,0,5
User659,0,0,3,2,0,5
User1567,0,0,2,3,0,5
User1757,2,0,3,0,0,5
User1747,0,0,2,3,0,5
User2700,0,3,0,2,0,5
User5450,0,0,0,5,0,5
User1793,1,0,4,0,0,5
User1629,1,2,0,1,1,5
User2709,0,3,1,1,0,5
User5170,3,1,1,0,0,5
User4551,0,0,4,1,0,5
User1973,0,0,2,3,0,5
User198,1,0,0,0,4,5
User3759,0,3,2,0,0,5
User552,2,0,2,1,0,5
User1900,0,3,0,2,0,5
User1630,0,1,3,1,0,5
User500,0,3,0,2,0,5
User3707,2,0,3,0,0,5
User4492,0,2,3,0,0,5
User5918,0,0,4,1,0,5
User2786,0,0,4,1,0,5
User2785,0,3,1,1,0,5
User4403,1,4,0,0,0,5
User3780,0,2,1,2,0,5
User1721,0,2,2,1,0,5
User2859,3,0,0,2,0,5
User529,5,0,0,0,0,5
User4409,2,3,0,0,0,5
User4411,0,3,0,0,2,5
User195,0,2,0,0,3,5
User2781,2,0,3,0,0,5
User4470,1,1,2,1,0,5
User4034,0,4,0,0,1,5
User2866,0,0,1,4,0,5
User2776,0,3,1,1,0,5
User5193,0,0,4,1,0,5
User4534,2,0,3,0,0,5
User2890,0,4,1,0,0,5
User493,0,3,0,1,1,5
User4417,0,1,4,0,0,5
User3696,0,0,1,4,0,5
User1894,0,0,5,0,0,5
User4366,1,0,0,4,0,5
User1890,0,0,5,0,0,5
User5502,0,0,0,5,0,5
User1888,5,0,0,0,0,5
User193,3,0,1,1,0,5
User4504,1,2,2,0,0,5
User1878,0,5,0,0,0,5
User2822,0,0,0,5,0,5
User4499,1,4,0,0,0,5
User2938,0,0,2,3,0,5
User3577,2,1,2,0,0,5
User4581,0,0,0,5,0,5
User1138,0,2,2,1,0,5
User4884,0,5,0,0,0,5
User856,0,0,3,2,0,5
User854,4,0,0,1,0,5
User849,0,1,3,1,0,5
User3229,0,5,0,0,0,5
User5037,0,0,4,1,0,5
User5657,0,1,2,2,0,5
User3421,0,3,0,2,0,5
User3424,0,0,0,5,0,5
User1122,0,2,0,0,3,5
User1127,0,0,2,3,0,5
User1150,0,0,3,2,0,5
User4582,0,5,0,0,0,5
User3193,0,3,2,0,0,5
User1154,0,0,0,5,0,5
User5051,0,3,2,0,0,5
User828,0,5,0,0,0,5
User3181,0,0,5,0,0,5
User3450,0,1,1,3,0,5
User3177,0,0,1,4,0,5
User4805,0,0,0,5,0,5
User5674,0,0,5,0,0,5
User6034,0,0,5,0,0,5
User1206,0,2,2,1,0,5
User4886,0,5,0,0,0,5
User3396,0,0,0,5,0,5
User3242,0,0,1,4,0,5
User1077,3,0,0,2,0,5
User930,0,0,0,5,0,5
User3333,1,1,2,0,1,5
User925,1,4,0,0,0,5
User958,0,3,1,1,0,5
User4962,0,4,1,0,0,5
User4960,0,4,0,1,0,5
User4955,1,1,3,0,0,5
User978,0,0,4,1,0,5
User4950,0,0,5,0,0,5
User984,0,4,0,1,0,5
User907,0,0,0,4,1,5
User5001,0,5,0,0,0,5
User3286,0,1,2,2,0,5
User4920,0,0,5,0,0,5
User3371,0,1,0,4,0,5
User4919,0,5,0,0,0,5
User4902,0,0,2,3,0,5
User5024,1,2,1,0,1,5
User1063,5,0,0,0,0,5
User3394,0,3,0,2,0,5
User5025,0,0,3,2,0,5
User4897,0,1,3,1,0,5
User3246,0,0,3,2,0,5
User4774,1,1,3,0,0,5
User5684,0,1,4,0,0,5
User1249,4,0,0,1,0,5
User3023,0,1,1,3,0,5
User3014,1,0,4,0,0,5
User3012,0,0,3,2,0,5
User3010,0,1,1,3,0,5
User4325,0,0,0,5,0,5
User3578,5,0,0,0,0,5
User698,0,4,0,1,0,5
User1451,0,1,0,4,0,5
User4613,4,0,1,0,0,5
User5146,0,0,5,0,0,5
User2992,0,1,2,2,0,5
User3600,0,1,0,4,0,5
User1484,0,2,0,3,0,5
User2973,0,0,1,4,0,5
User4601,1,3,1,0,0,5
User1504,0,1,0,0,4,5
User3629,3,0,1,1,0,5
User1512,0,0,0,0,5,5
User3632,0,1,1,3,0,5
User1514,0,0,0,5,0,5
User4591,0,0,3,2,0,5
User3635,0,1,0,4,0,5
User2948,0,0,1,4,0,5
User2947,0,1,0,4,0,5
User709,0,1,3,1,0,5
User5710,0,1,4,0,0,5
User3500,0,4,1,0,0,5
User4647,0,1,3,1,0,5
User1256,5,0,0,0,0,5
User1260,1,1,0,2,1,5
User3503,0,0,1,4,0,5
User3114,0,5,0,0,0,5
User1270,1,0,1,3,0,5
User147,0,4,0,0,1,5
User3107,1,0,3,1,0,5
User3518,0,0,3,2,0,5
User3519,0,0,1,4,0,5
User4726,0,4,0,0,1,5
User3523,0,0,1,4,0,5
User5095,0,2,3,0,0,5
User1326,0,0,0,5,0,5
User3540,1,1,1,2,0,5
User4691,0,4,0,1,0,5
User3052,0,4,1,0,0,5
User1372,0,0,0,5,0,5
User3562,0,2,2,1,0,5
User3043,5,0,0,0,0,5
User738,3,2,0,0,0,5
User1388,0,0,1,4,0,5
User1392,0,0,2,3,0,5
User3567,0,2,2,1,0,5
User2698,0,0,5,0,0,5
User5384,0,4,1,0,0,5
User5308,0,0,4,1,0,5
User4285,0,3,2,0,0,5
User414,0,0,0,0,5,5
User2312,1,0,4,0,0,5
User5441,0,5,0,0,0,5
User2121,0,2,3,0,0,5
User5796,0,0,5,0,0,5
User2316,0,0,0,5,0,5
User2317,0,0,4,1,0,5
User2658,0,0,0,5,0,5
User4147,0,0,4,1,0,5
User4280,3,0,2,0,0,5
User5855,1,0,3,1,0,5
User2539,0,3,2,0,0,5
User2132,2,0,1,2,0,5
User2323,0,0,2,3,0,5
User4153,2,3,0,0,0,5
User2324,0,2,1,2,0,5
User2454,0,0,1,1,3,5
User5857,1,2,2,0,0,5
User4072,0,3,2,0,0,5
User5366,0,3,2,0,0,5
User2341,2,2,1,0,0,5
User5272,0,5,0,0,0,5
User5302,0,5,0,0,0,5
User2112,0,3,2,0,0,5
User2653,2,0,0,3,0,5
User2474,0,4,0,1,0,5
User3884,0,0,5,0,0,5
User2493,0,2,3,0,0,5
User2092,0,0,0,5,0,5
User2502,0,1,0,4,0,5
User2094,2,3,0,0,0,5
User2635,0,2,3,0,0,5
User3974,2,1,0,1,1,5
User2625,0,5,0,0,0,5
User2621,0,0,4,1,0,5
User233,1,0,0,4,0,5
User2105,0,2,0,3,0,5
User5355,0,0,0,5,0,5
User3889,0,0,0,5,0,5
User2076,3,1,0,1,0,5
User2645,4,1,0,0,0,5
User3892,0,0,0,5,0,5
User2616,0,4,1,0,0,5
User4271,0,0,5,0,0,5
User2509,1,3,1,0,0,5
User2614,0,0,5,0,0,5
User4114,0,0,5,0,0,5
User5834,0,5,0,0,0,5
User2461,0,5,0,0,0,5
User4065,0,1,4,0,0,5
User2550,2,3,0,0,0,5
User3946,0,0,0,5,0,5
User3945,0,1,1,3,0,5
User2681,0,1,3,1,0,5
User4213,0,5,0,0,0,5
User3853,0,3,2,0,0,5
User4180,0,0,5,0,0,5
User5265,0,4,1,0,0,5
User2375,0,3,1,1,0,5
User4027,0,0,0,4,1,5
User4045,0,2,3,0,0,5
User2145,0,0,5,0,0,5
User4313,0,0,1,4,0,5
User2567,0,0,0,5,0,5
User5899,0,3,2,0,0,5
User60,3,2,0,0,0,5
User2389,0,2,1,2,0,5
User2569,0,1,0,4,0,5
User5823,0,4,0,1,0,5
User399,0,0,0,5,0,5
User2209,2,0,0,3,0,5
User2679,0,0,3,2,0,5
User2138,0,0,0,5,0,5
User1375,0,4,0,0,0,4
User3091,0,0,4,0,0,4
User1478,0,1,0,3,0,4
User4608,0,1,2,0,1,4
User4166,0,0,0,4,0,4
User3568,1,1,2,0,0,4
User5354,0,1,0,1,2,4
User3086,1,2,0,1,0,4
User3019,0,0,2,2,0,4
User2219,4,0,0,0,0,4
User5973,0,3,0,1,0,4
User2508,0,0,1,3,0,4
User2534,0,1,1,2,0,4
User4186,1,0,0,3,0,4
User2177,2,0,0,0,2,4
User4115,0,4,0,0,0,4
User4117,0,3,1,0,0,4
User4631,0,1,2,1,0,4
User5093,0,1,1,2,0,4
User2227,0,2,2,0,0,4
User4730,0,3,0,0,1,4
User1498,0,3,1,0,0,4
User776,1,0,2,1,0,4
User3514,0,2,2,0,0,4
User1282,0,3,1,0,0,4
User3615,0,2,0,2,0,4
User4191,0,0,4,0,0,4
User4604,0,3,1,0,0,4
User3099,0,0,0,4,0,4
User5533,0,3,0,1,0,4
User2980,0,1,2,1,0,4
User5536,0,0,0,0,4,4
User2276,1,1,2,0,0,4
User4111,1,0,2,1,0,4
User4731,0,2,2,0,0,4
User2269,0,4,0,0,0,4
User4710,0,2,0,2,0,4
User2513,0,0,1,3,0,4
User380,0,0,4,0,0,4
User2230,0,0,3,1,0,4
User4169,0,4,0,0,0,4
User5804,0,2,0,2,0,4
User4614,0,0,2,2,0,4
User3009,0,0,4,0,0,4
User2553,0,0,2,2,0,4
User2231,0,0,1,3,0,4
User5548,0,4,0,0,0,4
User3953,0,0,2,2,0,4
User4146,0,2,0,2,0,4
User3008,0,0,1,3,0,4
User1373,0,0,3,1,0,4
User2549,0,0,3,1,0,4
User3040,2,1,0,1,0,4
User3967,0,0,4,0,0,4
User3952,0,2,2,0,0,4
User3044,4,0,0,0,0,4
User1365,0,2,0,2,0,4
User746,1,0,3,0,0,4
User4705,0,2,2,0,0,4
User4685,0,2,2,0,0,4
User3542,0,0,1,3,0,4
User3068,0,4,0,0,0,4
User3546,4,0,0,0,0,4
User755,4,0,0,0,0,4
User1993,0,0,4,0,0,4
User5550,4,0,0,0,0,4
User5346,0,4,0,0,0,4
User2538,0,4,0,0,0,4
User2558,1,0,0,3,0,4
User1397,0,4,0,0,0,4
User2533,0,0,0,4,0,4
User3576,0,4,0,0,0,4
User3552,0,0,1,3,0,4
User1354,0,0,0,4,0,4
User2993,0,1,0,3,0,4
User3598,1,2,0,0,1,4
User3104,0,0,0,4,0,4
User5839,0,0,3,1,0,4
User4103,0,2,2,0,0,4
User2360,0,1,1,2,0,4
User3390,0,0,2,2,0,4
User3392,4,0,0,0,0,4
User871,0,1,0,3,0,4
User2433,0,1,0,3,0,4
User4009,1,0,2,1,0,4
User5819,0,4,0,0,0,4
User330,0,0,3,0,1,4
User2350,0,0,1,3,0,4
User2347,0,3,0,1,0,4
User2345,0,4,0,0,0,4
User4075,0,4,0,0,0,4
User1091,0,3,1,0,0,4
User3232,0,0,2,2,0,4
User2453,0,0,2,2,0,4
User3412,0,4,0,0,0,4
User2325,0,0,0,4,0,4
User4867,2,2,0,0,0,4
User4859,0,0,2,2,0,4
User305,0,3,0,0,1,4
User3423,0,0,3,1,0,4
User5364,2,0,1,0,1,4
User4855,0,2,0,2,0,4
User1121,0,0,1,3,0,4
User1124,0,3,0,0,1,4
User5043,0,0,1,3,0,4
User877,0,0,0,4,0,4
User1035,0,0,0,4,0,4
User3111,0,1,3,0,0,4
User1034,1,1,0,2,0,4
User4039,0,4,0,0,0,4
User2406,0,2,2,0,0,4
User3332,1,1,1,1,0,4
User3320,0,3,1,0,0,4
User2391,0,0,0,4,0,4
User952,1,2,0,1,0,4
User3317,0,0,0,4,0,4
User6022,0,0,4,0,0,4
User4966,0,0,0,4,0,4
User2410,2,0,0,2,0,4
User2411,1,1,2,0,0,4
User4961,0,0,4,0,0,4
User4959,2,2,0,0,0,4
User3348,0,0,0,4,0,4
User991,1,0,0,3,0,4
User4941,3,1,0,0,0,4
User3291,1,2,1,0,0,4
User5639,0,0,1,3,0,4
User6015,0,0,4,0,0,4
User5613,0,0,4,0,0,4
User3370,0,1,0,3,0,4
User2425,1,0,0,3,0,4
User3272,0,1,3,0,0,4
User2426,0,4,0,0,0,4
User1032,0,4,0,0,0,4
User3427,0,1,2,1,0,4
User3205,0,0,4,0,0,4
User4849,0,1,1,2,0,4
User4844,0,0,2,2,0,4
User3472,4,0,0,0,0,4
User3475,0,3,0,1,0,4
User3976,0,0,0,2,2,4
User3477,1,2,1,0,0,4
User1199,0,1,2,0,1,4
User809,1,0,0,3,0,4
User2478,3,0,1,0,0,4
User804,0,0,2,2,0,4
User3490,0,1,0,3,0,4
User2301,0,4,0,0,0,4
User364,0,1,3,0,0,4
User5155,0,4,0,0,0,4
User4762,0,0,4,0,0,4
User6036,0,4,0,0,0,4
User1245,0,4,0,0,0,4
User2298,0,0,1,3,0,4
User5840,0,1,2,1,0,4
User2292,1,1,0,2,0,4
User6037,0,4,0,0,0,4
User3973,1,2,1,0,0,4
User4101,0,1,3,0,0,4
User2285,0,0,4,0,0,4
User1269,0,0,3,1,0,4
User3510,0,0,3,1,0,4
User2283,0,2,0,2,0,4
User1195,1,3,0,0,0,4
User3470,0,0,3,1,0,4
User4799,0,1,3,0,0,4
User2309,2,0,2,0,0,4
User5047,0,4,0,0,0,4
User1147,0,4,0,0,0,4
User5049,0,3,0,1,0,4
User4079,0,1,1,2,0,4
User3189,0,3,0,1,0,4
User3443,2,2,0,0,0,4
User4082,0,3,1,0,0,4
User2313,0,0,0,4,0,4
User3183,0,0,2,2,0,4
User297,0,4,0,0,0,4
User4830,0,0,4,0,0,4
User4083,1,0,2,1,0,4
User3464,0,1,3,0,0,4
User5666,0,1,3,0,0,4
User4827,0,0,3,1,0,4
User5667,0,4,0,0,0,4
User1177,0,0,3,1,0,4
User5581,2,2,0,0,0,4
User4816,0,0,0,4,0,4
User3458,0,0,3,0,1,4
User355,1,1,0,2,0,4
User3460,0,0,2,1,1,4
User1188,4,0,0,0,0,4
User3463,0,0,1,3,0,4
User677,0,3,1,0,0,4
User4329,0,4,0,0,0,4
User5911,0,4,0,0,0,4
User4536,0,0,4,0,0,4
User4240,0,3,0,1,0,4
User2863,0,2,0,2,0,4
User1686,0,3,1,0,0,4
User4293,1,1,0,0,2,4
User1690,0,0,1,3,0,4
User5288,0,0,2,2,0,4
User4479,0,2,1,1,0,4
User4367,0,4,0,0,0,4
User1704,0,1,2,1,0,4
User2672,1,1,1,1,0,4
User4478,4,0,0,0,0,4
User3885,0,0,1,3,0,4
User2631,0,3,1,0,0,4
User5493,0,1,3,0,0,4
User3860,4,0,0,0,0,4
User1726,0,0,0,4,0,4
User1873,1,0,1,2,0,4
User4379,0,0,0,4,0,4
User3725,1,0,3,0,0,4
User5273,0,0,2,2,0,4
User4300,1,3,0,0,0,4
User1667,0,0,3,1,0,4
User620,1,0,2,1,0,4
User5511,3,0,0,1,0,4
User3677,0,0,0,4,0,4
User84,0,0,0,0,4,4
User5510,0,3,0,1,0,4
User1634,0,0,4,0,0,4
User3683,0,3,0,1,0,4
User2887,0,1,2,1,0,4
User1936,0,3,0,0,1,4
User2020,0,3,0,1,0,4
User4515,1,0,1,2,0,4
User2742,0,1,0,3,0,4
User547,2,1,0,1,0,4
User3692,1,2,0,0,1,4
User4520,1,0,2,1,0,4
User486,0,0,2,2,0,4
User4231,0,0,3,1,0,4
User3693,0,0,3,0,1,4
User3901,0,2,2,0,0,4
User3876,0,2,2,0,0,4
User5917,0,1,3,0,0,4
User5467,0,4,0,0,0,4
User2063,0,0,2,2,0,4
User1826,0,2,1,1,0,4
User2779,0,0,0,4,0,4
User3751,0,2,2,0,0,4
User1792,0,2,0,2,0,4
User4273,1,2,0,1,0,4
User3756,0,0,4,0,0,4
User2659,0,0,2,2,0,4
User2648,0,2,0,2,0,4
User545,2,1,1,0,0,4
User566,0,4,0,0,0,4
User3765,0,0,1,3,0,4
User1804,3,0,0,0,1,4
User5225,0,4,0,0,0,4
User3768,0,1,2,1,0,4
User3866,4,0,0,0,0,4
User5440,0,4,0,0,0,4
User1809,0,0,2,2,0,4
User4416,0,0,3,1,0,4
User4437,1,1,0,2,0,4
User2815,1,2,0,1,0,4
User3875,0,0,2,2,0,4
User4404,0,2,1,1,0,4
User2088,0,1,3,0,0,4
User1737,0,0,4,0,0,4
User4394,0,0,4,0,0,4
User2085,0,0,4,0,0,4
User4401,0,0,4,0,0,4
User2666,0,0,0,4,0,4
User2829,0,0,1,3,0,4
User1842,0,0,1,3,0,4
User2045,0,0,2,2,0,4
User2060,0,0,3,1,0,4
User1752,2,0,2,0,0,4
User2825,0,4,0,0,0,4
User2059,0,0,0,4,0,4
User4256,0,4,0,0,0,4
User3741,0,4,0,0,0,4
User2820,0,1,3,0,0,4
User4439,0,4,0,0,0,4
User568,0,0,0,4,0,4
User3813,0,0,0,4,0,4
User5765,0,2,0,2,0,4
User2686,0,0,1,3,0,4
User1618,0,3,0,1,0,4
User2578,0,2,0,2,0,4
User5310,1,2,0,0,1,4
User2579,0,0,2,2,0,4
User2706,1,3,0,0,0,4
User1591,2,1,1,0,0,4
User1974,0,2,0,2,0,4
User5264,0,4,0,0,0,4
User4218,0,4,0,0,0,4
User471,0,0,0,3,1,4
User5446,4,0,0,0,0,4
User4574,0,0,4,0,0,4
User1585,0,0,3,1,0,4
User2688,0,0,0,4,0,4
User5163,0,0,4,0,0,4
User2714,1,0,3,0,0,4
User5254,0,2,0,0,2,4
User2584,0,0,3,1,0,4
User2585,0,4,0,0,0,4
User3822,0,3,0,0,1,4
User5314,0,0,4,0,0,4
User2944,0,0,4,0,0,4
User4195,0,0,0,4,0,4
User5262,0,0,4,0,0,4
User2729,2,2,0,0,0,4
User2936,0,3,1,0,0,4
User3814,0,0,2,2,0,4
User4194,0,0,4,0,0,4
User1939,0,1,0,3,0,4
User4335,1,0,3,0,0,4
User1996,0,0,0,4,0,4
User1953,0,0,1,3,0,4
User3648,0,0,2,2,0,4
User4224,1,1,2,0,0,4
User3914,0,4,0,0,0,4
User1999,0,4,0,0,0,4
User2603,0,0,0,4,0,4
User4565,0,0,1,3,0,4
User4222,0,0,2,2,0,4
User1940,0,0,2,2,0,4
User5514,0,1,3,0,0,4
User2702,0,0,3,1,0,4
User3917,0,1,2,1,0,4
User652,0,0,3,1,0,4
User4994,0,1,1,1,0,3
User5257,0,0,1,1,1,3
User5380,0,1,1,1,0,3
User3986,3,0,0,0,0,3
User3863,0,0,2,1,0,3
User3992,0,0,0,3,0,3
User4852,2,0,0,1,0,3
User3784,0,1,0,2,0,3
User4048,0,0,1,2,0,3
User4951,1,1,0,0,1,3
User4351,0,1,0,2,0,3
User5044,3,0,0,0,0,3
User3983,0,1,1,1,0,3
User4978,0,3,0,0,0,3
User4974,0,0,3,0,0,3
User4318,0,3,0,0,0,3
User3865,0,0,3,0,0,3
User3441,1,0,2,0,0,3
User3841,0,0,0,3,0,3
User4413,0,1,0,2,0,3
User4330,0,0,2,1,0,3
User4842,0,0,3,0,0,3
User5587,0,0,3,0,0,3
User4077,0,0,2,1,0,3
User3436,0,0,3,0,0,3
User3837,0,0,3,0,0,3
User3434,0,0,3,0,0,3
User3781,0,1,1,1,0,3
User3836,0,0,0,3,0,3
User4043,1,0,1,1,0,3
User4958,0,1,0,2,0,3
User4956,0,0,3,0,0,3
User4848,0,0,1,2,0,3
User4387,0,0,3,0,0,3
User4286,0,3,0,0,0,3
User5250,1,2,0,0,0,3
User4888,0,0,3,0,0,3
User4895,0,0,3,0,0,3
User4365,0,0,2,1,0,3
User5247,0,1,0,2,0,3
User4924,0,3,0,0,0,3
User4923,0,3,0,0,0,3
User5270,0,1,2,0,0,3
User3395,2,0,0,1,0,3
User5011,0,0,0,3,0,3
User4052,0,1,2,0,0,3
User5251,1,2,0,0,0,3
User5371,0,3,0,0,0,3
User5041,0,0,2,1,0,3
User4355,0,2,1,0,0,3
User4354,0,2,0,1,0,3
User5603,0,0,3,0,0,3
User3372,0,2,0,1,0,3
User3810,0,0,1,2,0,3
User5017,0,1,1,1,0,3
User4914,0,0,0,3,0,3
User5460,0,0,3,0,0,3
User3374,0,0,2,1,0,3
User4913,0,2,1,0,0,3
User3379,0,2,0,1,0,3
User4298,0,0,0,3,0,3
User5010,0,3,0,0,0,3
User5009,0,3,0,0,0,3
User3855,0,0,1,2,0,3
User5379,0,2,0,1,0,3
User4996,0,3,0,0,0,3
User4864,1,0,1,1,0,3
User3351,0,1,1,1,0,3
User3352,2,0,0,0,1,3
User3861,0,3,0,0,0,3
User4341,0,2,0,0,1,3
User3995,0,0,0,3,0,3
User5620,0,0,2,1,0,3
User4019,0,0,3,0,0,3
User4873,1,0,0,2,0,3
User4376,0,1,1,1,0,3
User4877,0,3,0,0,0,3
User4939,0,3,0,0,0,3
User5388,0,3,0,0,0,3
User5378,1,1,0,0,1,3
User3819,0,2,1,0,0,3
User5600,0,1,2,0,0,3
User3999,0,0,3,0,0,3
User3361,0,1,2,0,0,3
User4017,1,0,2,0,0,3
User5393,0,0,3,0,0,3
User5003,0,3,0,0,0,3
User3618,0,0,3,0,0,3
User5577,0,3,0,0,0,3
User4836,0,3,0,0,0,3
User4556,0,2,0,1,0,3
User4149,0,3,0,0,0,3
User96,1,0,2,0,0,3
User4553,0,1,1,1,0,3
User3908,0,0,0,1,2,3
User5422,0,3,0,0,0,3
User4650,0,0,0,3,0,3
User4557,0,3,0,0,0,3
User3574,0,0,0,3,0,3
User5168,0,0,1,2,0,3
User4159,0,2,1,0,0,3
User5408,0,1,2,0,0,3
User4635,0,0,2,1,0,3
User4559,0,3,0,0,0,3
User4163,0,0,0,3,0,3
User5126,1,0,0,2,0,3
User5172,0,0,3,0,0,3
User4666,0,0,2,1,0,3
User4148,0,0,3,0,0,3
User4547,0,0,0,3,0,3
User4671,0,0,0,3,0,3
User3907,1,0,2,0,0,3
User3668,0,3,0,0,0,3
User5304,0,0,3,0,0,3
User4542,0,3,0,0,0,3
User4676,0,1,2,0,0,3
User3671,0,0,0,3,0,3
User4539,0,0,3,0,0,3
User5175,0,0,0,0,3,3
User4680,3,0,0,0,0,3
User5423,0,0,0,0,3,3
User4125,0,0,1,2,0,3
User3650,0,0,0,3,0,3
User5544,0,3,0,0,0,3
User5110,0,3,0,0,0,3
User4603,0,0,0,3,0,3
User16,0,1,0,0,2,3
User4606,0,2,1,0,0,3
User3933,0,1,0,2,0,3
User4206,0,3,0,0,0,3
User5320,0,2,0,1,0,3
User3604,1,1,0,1,0,3
User3929,0,3,0,0,0,3
User5332,1,0,1,1,0,3
User5415,0,3,0,0,0,3
User4193,0,1,2,0,0,3
User3612,0,0,3,0,0,3
User3627,0,0,1,2,0,3
User5151,0,0,3,0,0,3
User3622,0,2,0,1,0,3
User4588,2,1,0,0,0,3
User4188,2,1,0,0,0,3
User5158,0,0,2,1,0,3
User3601,0,0,1,2,0,3
User3644,0,1,0,2,0,3
User4577,0,0,3,0,0,3
User3944,0,2,0,1,0,3
User5328,0,3,0,0,0,3
User5145,0,2,1,0,0,3
User4174,0,3,0,0,0,3
User4624,0,0,0,3,0,3
User5142,0,0,1,2,0,3
User5419,0,0,1,2,0,3
User4573,0,0,1,2,0,3
User4214,0,1,2,0,0,3
User3649,0,0,1,2,0,3
User4563,0,3,0,0,0,3
User5351,3,0,0,0,0,3
User5179,0,3,0,0,0,3
User3772,0,0,0,3,0,3
User5569,0,1,2,0,0,3
User4788,0,0,1,2,0,3
User5529,0,0,1,2,0,3
User4785,1,0,1,1,0,3
User5573,0,3,0,0,0,3
User4090,0,0,2,1,0,3
User5071,0,3,0,0,0,3
User5286,0,3,0,0,0,3
User4091,0,0,0,3,0,3
User3732,2,1,0,0,0,3
User4771,0,3,0,0,0,3
User5567,0,0,3,0,0,3
User3731,2,0,1,0,0,3
User5082,0,0,0,0,3,3
User4755,3,0,0,0,0,3
User5213,0,1,2,0,0,3
User4789,0,3,0,0,0,3
User4798,0,3,0,0,0,3
User4436,0,2,0,1,0,3
User4089,3,0,0,0,0,3
User4803,0,0,3,0,0,3
User5059,1,2,0,0,0,3
User3753,0,1,2,0,0,3
User11,2,0,1,0,0,3
User4277,0,3,0,0,0,3
User3871,0,1,1,0,1,3
User3762,3,0,0,0,0,3
User5219,0,2,0,0,1,3
User3764,0,0,0,3,0,3
User5584,0,0,3,0,0,3
User5477,2,0,0,1,0,3
User3445,1,0,0,2,0,3
User4752,2,1,0,0,0,3
User5209,0,0,0,3,0,3
User4698,0,3,0,0,0,3
User3532,0,2,0,1,0,3
User4498,0,3,0,0,0,3
User3520,0,2,0,1,0,3
User3701,0,0,2,1,0,3
User4725,0,3,0,0,0,3
User4510,0,0,3,0,0,3
User3897,2,0,1,0,0,3
User3537,0,0,0,3,0,3
User5087,0,0,0,3,0,3
User3539,0,3,0,0,0,3
User3688,0,2,0,1,0,3
User3541,0,0,0,3,0,3
User4708,0,1,2,0,0,3
User5180,0,3,0,0,0,3
User5553,0,0,1,2,0,3
User3888,0,0,0,2,1,3
User5293,0,0,3,0,0,3
User4737,3,0,0,0,0,3
User5289,1,0,1,1,0,3
User3711,0,0,0,3,0,3
User3714,0,1,2,0,0,3
User5494,3,0,0,0,0,3
User5356,0,0,0,3,0,3
User4107,0,1,1,1,0,3
User3512,0,2,0,1,0,3
User4744,2,1,0,0,0,3
User4102,0,0,0,3,0,3
User5433,0,2,0,1,0,3
User4747,0,2,0,1,0,3
User5434,3,0,0,0,0,3
User5436,0,1,2,0,0,3
User5204,0,2,1,0,0,3
User4167,3,0,0,0,0,3
User2959,1,1,1,0,0,3
User3327,1,2,0,0,0,3
User1863,0,0,2,1,0,3
User2095,1,2,0,0,0,3
User2910,0,0,0,3,0,3
User5882,0,0,0,3,0,3
User2911,0,1,0,2,0,3
User2073,2,1,0,0,0,3
User1105,0,0,3,0,0,3
User5729,1,2,0,0,0,3
User6006,0,3,0,0,0,3
User2931,0,3,0,0,0,3
User2942,1,1,0,1,0,3
User2949,0,1,1,1,0,3
User1406,0,0,0,3,0,3
User2069,0,0,0,3,0,3
User1407,0,0,3,0,0,3
User166,0,0,0,0,3,3
User2953,1,0,1,1,0,3
User2955,0,3,0,0,0,3
User2960,0,2,1,0,0,3
User2051,0,0,1,2,0,3
User1405,0,0,0,3,0,3
User2096,0,3,0,0,0,3
User1396,0,2,0,1,0,3
User2872,0,3,0,0,0,3
User2852,0,2,1,0,0,3
User2146,0,0,1,2,0,3
User2856,0,3,0,0,0,3
User2143,0,0,0,3,0,3
User1141,1,0,2,0,0,3
User2865,3,0,0,0,0,3
User5877,1,1,0,1,0,3
User1384,1,0,1,1,0,3
User1139,0,0,0,0,3,3
User2101,0,1,2,0,0,3
User5744,0,3,0,0,0,3
User2131,0,3,0,0,0,3
User1135,0,0,0,3,0,3
User841,0,0,0,3,0,3
User1117,0,0,2,0,1,3
User1393,0,1,0,1,1,3
User2104,1,2,0,0,0,3
User2891,0,1,2,0,0,3
User1090,0,0,1,2,0,3
User6040,0,3,0,0,0,3
User2039,0,0,2,1,0,3
User3079,2,1,0,0,0,3
User1452,0,2,0,0,1,3
User3059,0,0,0,3,0,3
User5907,0,0,3,0,0,3
User3062,0,0,2,1,0,3
User5908,3,0,0,0,0,3
User485,0,3,0,0,0,3
User5699,0,1,2,0,0,3
User3077,0,0,3,0,0,3
User1041,2,0,0,1,0,3
User1947,0,2,1,0,0,3
User1889,0,1,0,2,0,3
User3083,0,0,3,0,0,3
User3085,0,0,0,3,0,3
User3090,2,0,1,0,0,3
User691,1,0,2,0,0,3
User3096,0,0,0,3,0,3
User5695,3,0,0,0,0,3
User3101,0,1,0,2,0,3
User3051,0,3,0,0,0,3
User1949,3,0,0,0,0,3
User2970,0,0,2,1,0,3
User1984,0,1,2,0,0,3
User5721,0,0,3,0,0,3
User2014,0,2,1,0,0,3
User2988,1,1,1,0,0,3
User2989,1,1,1,0,0,3
User2990,1,2,0,0,0,3
User2996,0,1,1,1,0,3
User2999,1,0,0,2,0,3
User2003,0,0,3,0,0,3
User1439,0,2,0,1,0,3
User1956,0,1,0,0,2,3
User5713,0,0,0,3,0,3
User3007,0,0,0,0,3,3
User3016,0,1,1,1,0,3
User1977,0,3,0,0,0,3
User3018,3,0,0,0,0,3
User3024,0,0,1,2,0,3
User1071,0,1,0,1,1,3
User1448,0,0,3,0,0,3
User2845,0,1,2,0,0,3
User2835,0,0,1,2,0,3
User2831,0,0,2,1,0,3
User2636,0,0,2,1,0,3
User2617,0,0,0,1,2,3
User1292,1,1,1,0,0,3
User2618,2,0,0,1,0,3
User5829,0,0,0,3,0,3
User2392,0,0,1,2,0,3
User2632,0,1,0,2,0,3
User2633,0,1,0,1,1,3
User1293,0,0,3,0,0,3
User2373,0,0,1,2,0,3
User2416,0,0,0,3,0,3
User2369,0,0,0,3,0,3
User2654,0,0,0,3,0,3
User806,2,0,0,1,0,3
User2365,0,2,0,1,0,3
User2670,0,1,0,2,0,3
User1305,0,1,2,0,0,3
User2348,0,1,0,1,1,3
User2674,0,3,0,0,0,3
User5828,3,0,0,0,0,3
User1291,0,0,1,2,0,3
User2340,0,0,0,3,0,3
User311,2,0,0,1,0,3
User2510,0,0,0,3,0,3
User2501,0,0,2,1,0,3
User2497,0,3,0,0,0,3
User5809,0,2,1,0,0,3
User2520,0,0,3,0,0,3
User2484,0,0,0,3,0,3
User1240,0,0,0,3,0,3
User5815,0,0,3,0,0,3
User5990,0,3,0,0,0,3
User2611,0,3,0,0,0,3
User2588,0,2,0,0,1,3
User1284,0,0,2,1,0,3
User2589,0,1,2,0,0,3
User2423,0,0,0,1,2,3
User2421,0,0,2,1,0,3
User2594,3,0,0,0,0,3
User2602,0,3,0,0,0,3
User2607,0,1,0,2,0,3
User2689,0,0,0,3,0,3
User1308,0,0,0,3,0,3
User5753,0,0,3,0,0,3
User398,0,0,1,2,0,3
User5850,0,3,0,0,0,3
User2238,0,0,1,2,0,3
User2221,0,0,0,3,0,3
User2799,0,0,0,3,0,3
User2801,0,1,0,2,0,3
User2214,2,1,0,0,0,3
User2211,1,0,2,0,0,3
User1169,0,0,0,3,0,3
User2813,0,1,0,2,0,3
User388,0,1,1,1,0,3
User2194,0,0,3,0,0,3
User2817,2,1,0,0,0,3
User5862,0,0,3,0,0,3
User1339,3,0,0,0,0,3
User5982,0,3,0,0,0,3
User2189,0,0,2,1,0,3
User1349,1,0,0,2,0,3
User2178,0,0,0,3,0,3
User2773,0,1,1,1,0,3
User2768,0,0,0,3,0,3
User351,0,3,0,0,0,3
User368,0,1,1,1,0,3
User5783,0,0,2,1,0,3
User2319,0,2,0,1,0,3
User1196,0,3,0,0,0,3
User2708,0,2,0,1,0,3
User2314,0,0,1,2,0,3
User2716,0,2,1,0,0,3
User356,0,1,1,1,0,3
User2296,0,3,0,0,0,3
User2284,1,0,1,1,0,3
User2766,0,1,0,2,0,3
User2728,0,0,1,2,0,3
User2733,2,0,0,1,0,3
User2279,2,1,0,0,0,3
User2264,0,3,0,0,0,3
User761,0,1,2,0,0,3
User2256,0,3,0,0,0,3
User2254,0,0,2,1,0,3
User2250,0,0,0,3,0,3
User886,1,0,2,0,0,3
User5806,0,3,0,0,0,3
User889,0,3,0,0,0,3
User959,1,0,1,1,0,3
User5644,0,0,3,0,0,3
User994,0,0,3,0,0,3
User5951,2,1,0,0,0,3
User3270,0,0,0,2,1,3
User3273,1,0,2,0,0,3
User1654,0,0,3,0,0,3
User614,0,2,1,0,0,3
User3171,0,1,1,1,0,3
User5670,0,2,0,0,1,3
User5949,0,3,0,0,0,3
User3166,1,2,0,0,0,3
User3165,1,2,0,0,0,3
User642,0,0,1,2,0,3
User1652,0,1,2,0,0,3
User956,0,0,0,3,0,3
User3285,0,1,0,2,0,3
User3161,0,0,1,2,0,3
User3288,0,0,2,1,0,3
User5638,0,3,0,0,0,3
User1812,1,1,1,0,0,3
User5948,3,0,0,0,0,3
User3155,1,2,0,0,0,3
User1502,0,0,1,2,0,3
User541,0,1,2,0,0,3
User6046,0,3,0,0,0,3
User1780,3,0,0,0,0,3
User3182,0,0,2,1,0,3
User944,0,2,1,0,0,3
User604,1,0,2,0,0,3
User1707,0,3,0,0,0,3
User5651,0,0,3,0,0,3
User650,0,0,3,0,0,3
User3226,0,0,2,1,0,3
User654,0,0,3,0,0,3
User3248,0,0,0,3,0,3
User1728,0,0,0,3,0,3
User5953,3,0,0,0,0,3
User3219,2,1,0,0,0,3
User599,0,3,0,0,0,3
User3217,0,0,3,0,0,3
User3216,0,0,0,3,0,3
User1673,1,0,1,1,0,3
User660,0,0,2,1,0,3
User970,0,0,2,1,0,3
User5956,0,3,0,0,0,3
User968,0,3,0,0,0,3
User1537,0,2,0,1,0,3
User1536,0,3,0,0,0,3
User577,0,1,2,0,0,3
User1529,0,0,0,3,0,3
User602,0,0,2,1,0,3
User5663,0,0,2,1,0,3
User1768,0,3,0,0,0,3
User1528,0,1,0,2,0,3
User5921,0,0,3,0,0,3
User976,0,0,2,1,0,3
User3141,0,0,0,1,2,3
User1499,0,3,0,0,0,3
User1023,0,1,1,1,0,3
User5633,3,0,0,0,0,3
User1622,0,0,0,3,0,3
User5628,0,3,0,0,0,3
User5685,0,0,3,0,0,3
User5945,0,3,0,0,0,3
User3310,1,0,0,2,0,3
User1851,0,0,0,0,3,3
User3143,0,1,2,0,0,3
User6012,0,0,3,0,0,3
User3144,0,1,1,0,1,3
User1616,0,1,2,0,0,3
User3311,0,0,3,0,0,3
User1596,0,1,0,1,0,2
User2470,0,0,0,2,0,2
User5843,0,2,0,0,0,2
User4110,0,0,1,1,0,2
User5844,0,2,0,0,0,2
User4116,0,1,1,0,0,2
User5846,0,0,2,0,0,2
User2266,0,0,0,2,0,2
User5192,0,0,2,0,0,2
User3982,0,1,0,1,0,2
User379,1,0,0,0,1,2
User5100,0,2,0,0,0,2
User5101,0,2,0,0,0,2
User4754,0,1,1,0,0,2
User1239,0,0,0,1,1,2
User3977,2,0,0,0,0,2
User2280,0,0,0,2,0,2
User5191,2,0,0,0,0,2
User4104,0,1,0,1,0,2
User2463,0,2,0,0,0,2
User1255,0,0,0,2,0,2
User3988,0,0,0,2,0,2
User1669,0,0,0,2,0,2
User4093,0,2,0,0,0,2
User365,0,0,0,0,2,2
User5985,0,0,2,0,0,2
User2462,0,0,1,1,0,2
User4497,1,1,0,0,0,2
User762,0,0,0,2,0,2
User4099,1,1,0,0,0,2
User4100,1,1,0,0,0,2
User3985,0,0,1,1,0,2
User2286,0,2,0,0,0,2
User3984,1,1,0,0,0,2
User1672,0,1,0,1,0,2
User2255,0,1,0,1,0,2
User2282,0,1,1,0,0,2
User1677,0,0,0,2,0,2
User5194,1,1,0,0,0,2
User4545,1,0,1,0,0,2
User5107,0,0,1,1,0,2
User5851,0,1,1,0,0,2
User1328,1,0,1,0,0,2
User5852,1,0,1,0,0,2
User4704,0,0,1,1,0,2
User2223,0,0,0,2,0,2
User4702,0,0,1,1,0,2
User5105,0,0,2,0,0,2
User758,0,2,0,0,0,2
User646,0,0,1,1,0,2
User3329,0,0,1,1,0,2
User384,0,0,0,2,0,2
User1698,0,1,0,1,0,2
User5336,0,2,0,0,0,2
User4540,0,2,0,0,0,2
User5174,0,0,0,2,0,2
User757,0,1,1,0,0,2
User1699,0,1,0,1,0,2
User5109,0,0,2,0,0,2
User4162,0,0,2,0,0,2
User2208,0,1,1,0,0,2
User2237,1,0,1,0,0,2
User5808,0,0,2,0,0,2
User4141,0,0,2,0,0,2
User4140,0,2,0,0,0,2
User4088,0,0,2,0,0,2
User4126,0,1,0,0,1,2
User5083,0,1,1,0,0,2
User5810,0,0,0,2,0,2
User4128,0,0,2,0,0,2
User5348,0,0,0,2,0,2
User5849,0,0,0,0,2,2
User4131,0,0,1,1,0,2
User1327,1,0,0,1,0,2
User4489,2,0,0,0,0,2
User5195,0,1,0,1,0,2
User2243,0,1,1,0,0,2
User1573,0,0,1,1,0,2
User4135,0,0,2,0,0,2
User4707,0,0,2,0,0,2
User3972,0,0,0,2,0,2
User2241,1,0,0,1,0,2
User4486,0,2,0,0,0,2
User5197,0,1,1,0,0,2
User1318,0,1,1,0,0,2
User4723,0,0,0,0,2,2
User4087,1,1,0,0,0,2
User4032,0,2,0,0,0,2
User5820,0,2,0,0,0,2
User2401,0,2,0,0,0,2
User4522,0,0,1,1,0,2
User1642,2,0,0,0,0,2
User4036,0,0,2,0,0,2
User4008,0,0,0,2,0,2
User4736,0,0,2,0,0,2
User1647,0,1,0,1,0,2
User2394,0,0,1,1,0,2
User5089,0,0,2,0,0,2
User4041,0,0,0,2,0,2
User6059,0,0,2,0,0,2
User4042,0,0,1,1,0,2
User4519,0,0,0,2,0,2
User2385,0,2,0,0,0,2
User4044,2,0,0,0,0,2
User6042,0,2,0,0,0,2
User5381,0,2,0,0,0,2
User4517,0,0,2,0,0,2
User4523,1,1,0,0,0,2
User2403,0,2,0,0,0,2
User5169,0,0,0,2,0,2
User4030,0,0,2,0,0,2
User4532,0,0,0,2,0,2
User5825,0,1,1,0,0,2
User2418,0,0,0,2,0,2
User1598,0,0,2,0,0,2
User4550,1,0,1,0,0,2
User4021,0,2,0,0,0,2
User4013,0,0,0,2,0,2
User778,0,0,2,0,0,2
User1592,0,0,0,2,0,2
User4527,1,1,0,0,0,2
User1290,0,1,1,0,0,2
User5386,2,0,0,0,0,2
User4011,0,0,0,2,0,2
User4526,0,0,2,0,0,2
User4010,0,1,0,0,1,2
User4025,0,0,0,0,2,2
User4739,0,0,1,1,0,2
User4524,0,2,0,0,0,2
User2415,0,1,1,0,0,2
User4733,0,0,2,0,0,2
User2370,0,0,1,1,0,2
User4721,0,0,2,0,0,2
User5368,0,0,2,0,0,2
User2339,0,0,0,2,0,2
User2336,1,1,0,0,0,2
User2331,0,0,0,2,0,2
User2452,0,0,1,1,0,2
User2322,0,0,0,2,0,2
User1257,0,0,0,2,0,2
User1657,0,2,0,0,0,2
User4078,0,0,2,0,0,2
User2459,2,0,0,0,0,2
User2315,0,0,0,2,0,2
User3991,0,0,2,0,0,2
User4724,0,1,0,1,0,2
User5362,0,2,0,0,0,2
User613,0,0,2,0,0,2
User3990,0,0,2,0,0,2
User1575,0,0,2,0,0,2
User5836,2,0,0,0,0,2
User4016,1,1,0,0,0,2
User4722,0,1,0,1,0,2
User1656,1,1,0,0,0,2
User4067,2,0,0,0,0,2
User4005,0,0,1,1,0,2
User1583,0,1,0,1,0,2
User2368,0,0,1,1,0,2
User4732,0,0,1,1,0,2
User2439,0,0,1,1,0,2
User1294,0,0,0,2,0,2
User4746,0,1,1,0,0,2
User4729,0,0,1,1,0,2
User4002,0,0,2,0,0,2
User5373,0,2,0,0,0,2
User4513,0,0,0,2,0,2
User2362,0,0,0,2,0,2
User2354,2,0,0,0,0,2
User4546,0,2,0,0,0,2
User6038,0,2,0,0,0,2
User5372,0,1,1,0,0,2
User316,0,0,0,0,2,2
User1333,0,0,0,2,0,2
User2351,0,0,0,0,2,2
User787,0,1,1,0,0,2
User3997,0,2,0,0,0,2
User4062,0,1,0,1,0,2
User4182,0,0,2,0,0,2
User4165,2,0,0,0,0,2
User2049,0,0,2,0,0,2
User1425,0,0,0,2,0,2
User1431,0,0,0,1,1,2
User1519,0,1,1,0,0,2
User1806,0,0,0,2,0,2
User1435,0,0,2,0,0,2
User4317,1,0,1,0,0,2
User1997,0,0,0,2,0,2
User5901,2,0,0,0,0,2
User1991,0,0,0,0,2,2
User1990,0,0,0,2,0,2
User5140,1,0,1,0,0,2
User5141,1,0,0,1,0,2
User4324,0,0,1,1,0,2
User5902,0,1,0,1,0,2
User1510,1,0,0,1,0,2
User5154,0,2,0,0,0,2
User4597,0,0,2,0,0,2
User1981,0,0,2,0,0,2
User1442,1,0,0,1,0,2
User4331,0,0,0,2,0,2
User1835,1,0,0,1,0,2
User467,1,0,1,0,0,2
User1443,0,0,2,0,0,2
User2008,0,1,1,0,0,2
User5897,0,2,0,0,0,2
User5896,0,0,0,2,0,2
User2032,0,2,0,0,0,2
User2047,1,1,0,0,0,2
User5220,0,0,2,0,0,2
User4287,0,2,0,0,0,2
User4289,0,0,0,2,0,2
User5274,0,0,2,0,0,2
User4291,0,0,1,1,0,2
User4292,1,1,0,0,0,2
User4427,0,0,2,0,0,2
User5970,0,0,2,0,0,2
User442,0,0,1,0,1,2
User5157,0,2,0,0,0,2
User4422,0,0,0,2,0,2
User5892,0,2,0,0,0,2
User4637,0,2,0,0,0,2
User5139,2,0,0,0,0,2
User5894,2,0,0,0,0,2
User1421,0,0,1,1,0,2
User4306,0,0,0,2,0,2
User4307,0,0,2,0,0,2
User5968,0,0,2,0,0,2
User5223,0,2,0,0,0,2
User4423,0,2,0,0,0,2
User4407,0,0,0,2,0,2
User5255,0,2,0,0,0,2
User5231,2,0,0,0,0,2
User4392,2,0,0,0,0,2
User4616,0,0,0,2,0,2
User5235,0,0,0,1,1,2
User4368,0,2,0,0,0,2
User1464,0,0,2,0,0,2
User4370,0,1,0,0,1,2
User1467,0,0,0,2,0,2
User5919,0,0,2,0,0,2
User4373,0,2,0,0,0,2
User4374,0,1,1,0,0,2
User1491,0,2,0,0,0,2
User5236,0,2,0,0,0,2
User4364,0,1,0,1,0,2
User1882,1,0,1,0,0,2
User5149,0,1,0,1,0,2
User683,0,2,0,0,0,2
User4377,0,2,0,0,0,2
User4378,0,2,0,0,0,2
User4380,0,2,0,0,0,2
User5148,0,1,1,0,0,2
User1472,0,0,0,2,0,2
User5915,0,2,0,0,0,2
User4385,0,0,0,2,0,2
User1901,1,0,0,1,0,2
User693,0,0,0,2,0,2
User4338,0,0,1,1,0,2
User4350,0,1,1,0,0,2
User4340,0,0,0,0,2,2
User5906,1,1,0,0,0,2
User4342,0,0,0,2,0,2
User5920,0,2,0,0,0,2
User4344,0,1,0,1,0,2
User1946,0,0,1,1,0,2
User1497,0,0,1,1,0,2
User4347,1,1,0,0,0,2
User1845,1,1,0,0,0,2
User1943,0,0,0,2,0,2
User4400,1,0,0,1,0,2
User1902,1,0,0,1,0,2
User5150,0,2,0,0,0,2
User1934,0,2,0,0,0,2
User5909,0,0,2,0,0,2
User1923,0,0,0,2,0,2
User4620,0,2,0,0,0,2
User1492,0,1,1,0,0,2
User4619,0,0,2,0,0,2
User1905,0,0,0,2,0,2
User4397,0,1,0,1,0,2
User4361,0,2,0,0,0,2
User438,0,2,0,0,0,2
User432,0,0,0,2,0,2
User2201,0,1,0,1,0,2
User4279,0,0,1,1,0,2
User2156,0,0,0,2,0,2
User1730,0,0,0,1,1,2
User1367,0,2,0,0,0,2
User2151,0,0,2,0,0,2
User1368,1,0,0,1,0,2
User5121,0,2,0,0,0,2
User5122,0,0,2,0,0,2
User4205,0,2,0,0,0,2
User5977,0,0,2,0,0,2
User4465,0,1,1,0,0,2
User5954,0,0,0,2,0,2
User1377,1,0,0,1,0,2
User4669,0,0,0,2,0,2
User2141,0,0,2,0,0,2
User4460,0,0,1,1,0,2
User4216,1,0,0,1,0,2
User5206,0,2,0,0,0,2
User1732,0,0,0,2,0,2
User5309,0,1,1,0,0,2
User5207,0,2,0,0,0,2
User1733,0,0,0,2,0,2
User4455,0,0,0,2,0,2
User5307,0,2,0,0,0,2
User745,0,0,0,2,0,2
User2159,0,0,0,2,0,2
User4681,1,0,1,0,0,2
User4474,0,0,1,1,0,2
User5860,0,0,2,0,0,2
User1334,0,0,2,0,0,2
User4480,0,0,1,1,0,2
User2196,0,0,1,1,0,2
User5198,0,2,0,0,0,2
User4476,0,1,0,1,0,2
User4693,1,0,0,1,0,2
User5329,0,1,0,0,1,2
User5199,0,2,0,0,0,2
User4175,2,0,0,0,0,2
User4473,0,0,0,2,0,2
User5117,0,2,0,0,0,2
User1718,0,0,1,1,0,2
User2186,0,2,0,0,0,2
User2185,0,2,0,0,0,2
User4386,1,1,0,0,0,2
User5200,0,2,0,0,0,2
User4567,0,0,1,1,0,2
User4568,0,1,1,0,0,2
User4187,0,0,2,0,0,2
User5867,0,2,0,0,0,2
User753,0,0,1,1,0,2
User409,2,0,0,0,0,2
User410,0,0,1,0,1,2
User4454,0,1,1,0,0,2
User4649,0,0,1,1,0,2
User4583,0,1,1,0,0,2
User5884,0,0,1,1,0,2
User5284,0,2,0,0,0,2
User5160,0,2,0,0,0,2
User1779,0,0,1,1,0,2
User4263,0,0,2,0,0,2
User1786,0,1,1,0,0,2
User4759,2,0,0,0,0,2
User5885,2,0,0,0,0,2
User4585,0,0,0,2,0,2
User5133,2,0,0,0,0,2
User4258,0,0,0,2,0,2
User4270,2,0,0,0,0,2
User1790,2,0,0,0,0,2
User5217,0,0,2,0,0,2
User4274,0,0,0,2,0,2
User4276,0,2,0,0,0,2
User5159,0,0,1,1,0,2
User1526,0,0,1,1,0,2
User4430,2,0,0,0,0,2
User2062,0,1,1,0,0,2
User6052,2,0,0,0,0,2
User4652,0,0,0,2,0,2
User2074,0,0,2,0,0,2
User5305,0,0,0,2,0,2
User4659,0,1,0,1,0,2
User5879,0,2,0,0,0,2
User2123,0,1,1,0,0,2
User5880,0,0,0,2,0,2
User2116,0,0,0,2,0,2
User731,0,0,0,2,0,2
User5301,0,2,0,0,0,2
User4662,0,0,0,2,0,2
User4450,0,1,0,0,1,2
User5929,0,2,0,0,0,2
User730,1,0,0,1,0,2
User2099,0,0,0,2,0,2
User2077,0,0,2,0,0,2
User4243,1,0,1,0,0,2
User4244,0,0,2,0,0,2
User4580,0,2,0,0,0,2
User5290,0,0,2,0,0,2
User2093,0,0,0,2,0,2
User2084,0,1,0,1,0,2
User4252,2,0,0,0,0,2
User5130,0,0,0,2,0,2
User5131,0,0,1,1,0,2
User4255,0,2,0,0,0,2
User4264,0,1,1,0,0,2
User3935,0,0,2,0,0,2
User5805,0,0,2,0,0,2
User5532,0,0,1,1,0,2
User4891,0,0,2,0,0,2
User4890,0,1,1,0,0,2
User3011,0,0,0,2,0,2
User3580,0,0,2,0,0,2
User5543,0,1,0,1,0,2
User3003,0,0,1,1,0,2
User3002,1,1,0,0,0,2
User5542,0,0,0,2,0,2
User6029,0,0,2,0,0,2
User5540,0,1,1,0,0,2
User3587,0,0,0,2,0,2
User3588,0,0,2,0,0,2
User3589,0,0,2,0,0,2
User5030,0,1,1,0,0,2
User3591,0,0,2,0,0,2
User857,0,0,1,1,0,2
User3595,0,2,0,0,0,2
User3597,0,0,0,2,0,2
User5716,0,0,1,1,0,2
User1081,0,1,0,1,0,2
User4883,0,2,0,0,0,2
User2978,1,1,0,0,0,2
User5535,0,0,2,0,0,2
User3606,0,1,0,1,0,2
User5534,2,0,0,0,0,2
User2977,0,0,0,2,0,2
User5719,0,0,0,1,1,2
User3017,0,0,0,2,0,2
User5028,0,0,2,0,0,2
User3032,2,0,0,0,0,2
User5701,0,2,0,0,0,2
User3084,0,1,0,1,0,2
User3526,0,0,1,1,0,2
User3529,2,0,0,0,0,2
User3082,1,0,0,0,1,2
User1044,2,0,0,0,0,2
User3533,1,0,1,0,0,2
User3534,2,0,0,0,0,2
User3536,0,0,0,2,0,2
User3075,0,1,1,0,0,2
User1060,0,0,0,2,0,2
User3071,0,1,0,1,0,2
User3070,0,0,2,0,0,2
User151,0,2,0,0,0,2
User5546,0,0,0,2,0,2
User866,0,2,0,0,0,2
User865,1,1,0,0,0,2
User3550,0,0,0,2,0,2
User3060,0,1,1,0,0,2
User4898,0,2,0,0,0,2
User3554,0,2,0,0,0,2
User3556,0,1,1,0,0,2
User3557,2,0,0,0,0,2
User5547,0,0,2,0,0,2
User3049,0,2,0,0,0,2
User3047,0,0,1,1,0,2
User3561,0,2,0,0,0,2
User2971,0,0,0,2,0,2
User6030,0,2,0,0,0,2
User3710,0,0,2,0,0,2
User2969,0,0,1,1,0,2
User5513,0,2,0,0,0,2
User5733,0,0,2,0,0,2
User5512,0,2,0,0,0,2
User3673,0,0,1,1,0,2
User5736,1,1,0,0,0,2
User3675,0,0,2,0,0,2
User2898,0,0,0,2,0,2
User4862,0,0,2,0,0,2
User5040,0,2,0,0,0,2
User4860,0,2,0,0,0,2
User1110,0,0,0,2,0,2
User4858,0,1,0,1,0,2
User4857,0,0,2,0,0,2
User2885,0,1,0,1,0,2
User5508,0,1,1,0,0,2
User6004,0,2,0,0,0,2
User3687,0,0,1,1,0,2
User2883,0,2,0,0,0,2
User3689,0,0,2,0,0,2
User5742,0,0,2,0,0,2
User838,0,0,1,1,0,2
User3695,0,0,0,2,0,2
User5745,0,2,0,0,0,2
User2871,0,0,2,0,0,2
User3703,0,1,0,1,0,2
User3704,0,0,2,0,0,2
User6003,0,0,2,0,0,2
User2907,0,1,1,0,0,2
User3666,0,2,0,0,0,2
User2912,0,0,0,2,0,2
User122,1,1,0,0,0,2
User3619,0,0,2,0,0,2
User2964,2,0,0,0,0,2
User5528,0,1,1,0,0,2
User2962,0,0,2,0,0,2
User3624,0,2,0,0,0,2
User5526,0,2,0,0,0,2
User3626,0,0,1,1,0,2
User3628,2,0,0,0,0,2
User5525,0,0,1,1,0,2
User4874,2,0,0,0,0,2
User3637,0,0,0,2,0,2
User5522,0,0,2,0,0,2
User3641,0,0,0,2,0,2
User3663,0,0,2,0,0,2
User3642,0,0,0,2,0,2
User3645,0,0,2,0,0,2
User2943,0,0,0,2,0,2
User1098,0,2,0,0,0,2
User5517,0,0,2,0,0,2
User2921,2,0,0,0,0,2
User1108,0,0,0,2,0,2
User4866,2,0,0,0,0,2
User5038,0,2,0,0,0,2
User3659,0,1,0,1,0,2
User3660,0,0,2,0,0,2
User1109,0,0,0,1,1,2
User3094,0,1,1,0,0,2
User5693,0,0,1,1,0,2
User5692,0,0,0,2,0,2
User5562,0,1,1,0,0,2
User3265,0,0,0,2,0,2
User3380,1,1,0,0,0,2
User6024,1,1,0,0,0,2
User3264,0,2,0,0,0,2
User967,0,0,0,1,1,2
User3260,0,2,0,0,0,2
User5604,1,1,0,0,0,2
User3389,0,2,0,0,0,2
User4957,2,0,0,0,0,2
User5648,0,2,0,0,0,2
User3256,0,0,1,1,0,2
User6020,0,2,0,0,0,2
User3250,0,0,1,1,0,2
User920,0,2,0,0,0,2
User3240,0,0,1,1,0,2
User5602,2,0,0,0,0,2
User3238,0,1,1,0,0,2
User5601,0,0,0,2,0,2
User4954,0,0,0,2,0,2
User4995,0,0,1,1,0,2
User5653,0,1,0,1,0,2
User3406,0,1,0,0,1,2
User5596,0,0,2,0,0,2
User5595,0,1,1,0,0,2
User3410,0,0,2,0,0,2
User3228,0,0,1,1,0,2
User916,0,2,0,0,0,2
User5609,0,0,2,0,0,2
User3267,0,0,0,2,0,2
User5611,0,0,1,1,0,2
User3296,0,0,0,2,0,2
User3330,0,0,2,0,0,2
User3322,0,0,0,2,0,2
User938,2,0,0,0,0,2
User4985,0,2,0,0,0,2
User5630,0,0,0,2,0,2
User934,0,0,2,0,0,2
User4976,1,1,0,0,0,2
User4973,1,1,0,0,0,2
User3302,0,0,2,0,0,2
User4971,1,1,0,0,0,2
User3299,1,0,1,0,0,2
User3298,0,0,0,2,0,2
User3295,0,0,0,0,2,2
User5643,1,1,0,0,0,2
User3292,1,0,1,0,0,2
User947,0,1,0,0,1,2
User3358,1,0,0,1,0,2
User5617,0,0,2,0,0,2
User950,0,1,0,1,0,2
User926,0,0,2,0,0,2
User3282,0,0,1,1,0,2
User5641,0,0,2,0,0,2
User3366,0,1,0,1,0,2
User3279,0,0,0,2,0,2
User3277,0,0,2,0,0,2
User5612,2,0,0,0,0,2
User5593,0,2,0,0,0,2
User986,1,1,0,0,0,2
User5658,0,0,2,0,0,2
User896,2,0,0,0,0,2
User5002,0,0,0,2,0,2
User5580,0,2,0,0,0,2
User3469,0,0,2,0,0,2
User3156,0,0,1,0,1,2
User3473,0,1,1,0,0,2
User3151,1,1,0,0,0,2
User4929,0,0,2,0,0,2
User5008,0,0,1,1,0,2
User3150,0,2,0,0,0,2
User5681,0,0,1,1,0,2
User4927,0,0,2,0,0,2
User1015,1,1,0,0,0,2
User3145,0,2,0,0,0,2
User3462,0,0,2,0,0,2
User1019,0,0,0,2,0,2
User1022,0,0,0,2,0,2
User3493,0,0,0,2,0,2
User5013,0,0,2,0,0,2
User5687,0,2,0,0,0,2
User3126,0,0,1,1,0,2
User3118,0,0,0,2,0,2
User3505,0,1,1,0,0,2
User3507,0,0,0,2,0,2
User5564,0,0,2,0,0,2
User5016,0,0,0,2,0,2
User5691,1,1,0,0,0,2
User3163,2,0,0,0,0,2
User4937,0,2,0,0,0,2
User4947,0,1,0,0,1,2
User3197,0,0,1,1,0,2
User3220,0,2,0,0,0,2
User5591,0,0,1,1,0,2
User988,0,0,0,2,0,2
User3213,0,0,2,0,0,2
User5589,1,0,1,0,0,2
User3204,0,1,0,1,0,2
User3203,0,1,1,0,0,2
User3201,0,1,0,1,0,2
User3432,2,0,0,0,0,2
User3433,1,0,1,0,0,2
User3200,0,2,0,0,0,2
User3199,0,0,1,1,0,2
User3196,1,1,0,0,0,2
User3456,0,0,0,2,0,2
User3439,0,2,0,0,0,2
User5662,0,0,2,0,0,2
User3190,1,0,1,0,0,2
User3188,1,0,1,0,0,2
User3186,0,1,1,0,0,2
User3447,0,2,0,0,0,2
User5585,0,2,0,0,0,2
User3449,0,2,0,0,0,2
User3452,0,0,0,2,0,2
User1000,0,0,2,0,0,2
User4938,0,1,1,0,0,2
User5668,0,2,0,0,0,2
User4847,0,0,2,0,0,2
User3661,0,1,0,1,0,2
User1614,0,2,0,0,0,2
User5776,0,2,0,0,0,2
User3806,0,2,0,0,0,2
User2591,0,2,0,0,0,2
User5462,0,0,0,2,0,2
User3913,0,2,0,0,0,2
User1184,0,0,2,0,0,2
User4806,0,1,1,0,0,2
User2737,0,0,0,2,0,2
User2736,0,0,0,2,0,2
User3812,0,0,0,2,0,2
User3912,0,0,2,0,0,2
User2731,0,0,1,1,0,2
User4802,0,0,2,0,0,2
User5459,1,1,0,0,0,2
User4777,0,2,0,0,0,2
User3818,0,0,1,1,0,2
User2725,0,1,1,0,0,2
User3820,0,0,0,2,0,2
User5421,0,0,2,0,0,2
User3821,0,0,0,2,0,2
User2596,0,0,0,2,0,2
User3905,0,2,0,0,0,2
User1190,0,0,0,2,0,2
User3916,0,1,0,1,0,2
User2586,0,2,0,0,0,2
User5797,0,0,2,0,0,2
User1183,0,0,0,2,0,2
User5767,0,0,2,0,0,2
User3925,1,1,0,0,0,2
User5470,0,2,0,0,0,2
User3789,0,2,0,0,0,2
User4815,0,1,1,0,0,2
User2764,0,2,0,0,0,2
User4814,0,1,0,1,0,2
User2652,0,0,0,2,0,2
User5798,0,0,2,0,0,2
User3794,0,1,0,1,0,2
User818,0,1,1,0,0,2
User2753,0,0,0,2,0,2
User4812,0,0,2,0,0,2
User3923,0,0,1,1,0,2
User5465,0,2,0,0,0,2
User2748,0,0,1,1,0,2
User4810,0,0,0,2,0,2
User2741,0,0,2,0,0,2
User3803,1,0,1,0,0,2
User5073,0,0,2,0,0,2
User5072,0,0,0,2,0,2
User1191,0,0,2,0,0,2
User3904,1,0,1,0,0,2
User2771,0,2,0,0,0,2
User5792,0,0,0,2,0,2
User3847,0,0,1,1,0,2
User5784,0,0,0,2,0,2
User3887,0,0,2,0,0,2
User4794,1,0,0,1,0,2
User5447,0,0,1,1,0,2
User2683,0,0,1,1,0,2
User2680,0,2,0,0,0,2
User2629,0,1,0,1,0,2
User3882,0,2,0,0,0,2
User5435,0,2,0,0,0,2
User5437,0,2,0,0,0,2
User2613,0,0,1,1,0,2
User3877,0,1,1,0,0,2
User1197,0,1,0,1,0,2
User2669,0,0,1,1,0,2
User2668,0,2,0,0,0,2
User3864,0,0,0,1,1,2
User2638,1,0,1,0,0,2
User1209,0,2,0,0,0,2
User811,0,1,0,1,0,2
User5439,0,0,2,0,0,2
User5789,2,0,0,0,0,2
User245,0,1,0,1,0,2
User4781,0,2,0,0,0,2
User3891,0,0,2,0,0,2
User5449,0,2,0,0,0,2
User2721,0,0,1,1,0,2
User5070,0,1,1,0,0,2
User5426,0,1,0,0,1,2
User5427,0,2,0,0,0,2
User5779,0,1,0,1,0,2
User5780,0,0,2,0,0,2
User3831,0,0,2,0,0,2
User2615,0,0,1,0,1,2
User1193,0,1,1,0,0,2
User5069,0,0,0,2,0,2
User4797,1,1,0,0,0,2
User2712,0,1,0,1,0,2
User3838,0,0,2,0,0,2
User2707,0,2,0,0,0,2
User3895,0,1,1,0,0,2
User2703,0,0,1,1,0,2
User5429,0,2,0,0,0,2
User5451,0,2,0,0,0,2
User3843,0,0,1,1,0,2
User2693,1,1,0,0,0,2
User5430,0,2,0,0,0,2
User2577,1,0,0,1,0,2
User2758,0,1,0,1,0,2
User2780,0,0,0,2,0,2
User2807,0,0,2,0,0,2
User4767,0,0,0,0,2,2
User4835,0,2,0,0,0,2
User829,0,2,0,0,0,2
User3739,0,0,1,1,0,2
User2546,0,2,0,0,0,2
User3740,0,1,0,1,0,2
User2821,0,1,0,1,0,2
User3948,0,0,2,0,0,2
User5485,0,0,2,0,0,2
User2782,0,0,2,0,0,2
User5754,0,0,2,0,0,2
User2814,0,2,0,0,0,2
User3747,0,2,0,0,0,2
User4832,0,0,1,1,0,2
User5052,0,2,0,0,0,2
User2551,0,1,1,0,0,2
User4829,0,0,0,2,0,2
User5992,0,1,1,0,0,2
User253,0,2,0,0,0,2
User1161,0,1,0,0,1,2
User3734,0,0,0,2,0,2
User5802,0,1,0,1,0,2
User1234,0,2,0,0,0,2
User834,2,0,0,0,0,2
User3961,0,0,0,2,0,2
User3959,0,1,1,0,0,2
User2854,0,1,1,0,0,2
User3715,0,0,1,1,0,2
User1149,0,0,0,2,0,2
User5495,0,0,0,2,0,2
User2516,0,0,1,1,0,2
User4841,0,2,0,0,0,2
User3733,0,1,1,0,0,2
User3719,0,0,1,0,1,2
User2851,0,1,1,0,0,2
User5048,0,0,2,0,0,2
User2841,0,0,0,0,2,2
User2839,0,1,0,1,0,2
User1152,0,0,0,2,0,2
User832,0,2,0,0,0,2
User5752,0,2,0,0,0,2
User3755,0,0,0,2,0,2
User2819,0,0,1,1,0,2
User4826,1,1,0,0,0,2
User4773,0,1,0,1,0,2
User5763,0,1,1,0,0,2
User4819,0,0,0,1,1,2
User3770,0,1,1,0,0,2
User1173,0,2,0,0,0,2
User2568,0,2,0,0,0,2
User2790,0,1,0,1,0,2
User3773,0,1,1,0,0,2
User3932,0,1,1,0,0,2
User2571,1,0,0,1,0,2
User1172,0,0,0,2,0,2
User5475,0,0,0,2,0,2
User3775,1,1,0,0,0,2
User2787,0,1,1,0,0,2
User2575,0,0,0,2,0,2
User3927,0,1,1,0,0,2
User5474,0,2,0,0,0,2
User5473,0,2,0,0,0,2
User4817,0,1,0,1,0,2
User2795,0,0,0,2,0,2
User2655,0,0,0,2,0,2
User5410,0,0,0,2,0,2
User4823,0,0,2,0,0,2
User5479,0,0,1,1,0,2
User2562,0,0,0,2,0,2
User2561,0,0,2,0,0,2
User1225,0,0,1,1,0,2
User2559,1,0,0,1,0,2
User3943,0,0,0,2,0,2
User5173,0,1,1,0,0,2
User2565,0,1,0,1,0,2
User3938,1,1,0,0,0,2
User5067,0,0,0,1,0,1
User5074,0,1,0,0,0,1
User5957,0,1,0,0,0,1
User4986,0,1,0,0,0,1
User5950,0,0,0,1,0,1
User6018,0,0,1,0,0,1
User5161,0,1,0,0,0,1
User5167,0,0,1,0,0,1
User5092,0,0,0,1,0,1
User4999,0,0,1,0,0,1
User4998,0,0,1,0,0,1
User5996,0,1,0,0,0,1
User5075,0,1,0,0,0,1
User5080,0,0,0,1,0,1
User5000,0,0,1,0,0,1
User6019,0,0,0,1,0,1
User5991,0,0,1,0,0,1
User5079,0,1,0,0,0,1
User5994,0,1,0,0,0,1
User6021,0,0,1,0,0,1
User4987,0,0,1,0,0,1
User5085,0,0,0,1,0,1
User5164,0,0,0,1,0,1
User5955,0,0,1,0,0,1
User4989,0,0,1,0,0,1
User6017,0,1,0,0,0,1
User5091,0,1,0,0,0,1
User5076,0,0,0,0,1,1
User4997,0,0,0,1,0,1
User4993,0,1,0,0,0,1
User5166,0,0,1,0,0,1
User5077,0,0,0,0,1,1
User4991,0,0,0,1,0,1
User5084,0,0,0,1,0,1
User4988,0,1,0,0,0,1
User5171,0,0,0,1,0,1
User5078,0,1,0,0,0,1
User5993,0,0,1,0,0,1
User6035,0,0,1,0,0,1
User5995,0,1,0,0,0,1
User5952,0,0,0,0,1,1
User6039,0,1,0,0,0,1
User5947,0,0,1,0,0,1
User6002,0,1,0,0,0,1
User5989,0,1,0,0,0,1
User5033,0,1,0,0,0,1
User5054,0,0,1,0,0,1
User5134,0,0,1,0,0,1
User5108,0,0,0,1,0,1
User5972,0,1,0,0,0,1
User6032,0,0,0,0,1,1
User5035,0,0,0,1,0,1
User5034,1,0,0,0,0,1
User6007,0,0,1,0,0,1
User5055,0,0,0,1,0,1
User5056,0,1,0,0,0,1
User5971,0,1,0,0,0,1
User6008,0,0,0,1,0,1
User5036,0,0,1,0,0,1
User5104,0,1,0,0,0,1
User5135,0,0,1,0,0,1
User5136,0,1,0,0,0,1
User5137,0,0,1,0,0,1
User5138,0,1,0,0,0,1
User6009,0,0,1,0,0,1
User5969,0,0,1,0,0,1
User5103,0,1,0,0,0,1
User5031,0,1,0,0,0,1
User6033,0,1,0,0,0,1
User5102,0,1,0,0,0,1
User6031,0,1,0,0,0,1
User5053,0,1,0,0,0,1
User5958,0,0,1,0,0,1
User5979,0,0,1,0,0,1
User5976,0,1,0,0,0,1
User5975,0,0,1,0,0,1
User5123,0,0,0,1,0,1
User5125,0,0,1,0,0,1
User5045,0,1,0,0,0,1
User5120,0,1,0,0,0,1
User5974,0,1,0,0,0,1
User5042,0,0,1,0,0,1
User5118,0,0,0,1,0,1
User5116,0,0,0,1,0,1
User5115,0,0,1,0,0,1
User5050,0,0,0,0,1,1
User5132,0,0,1,0,0,1
User5114,0,1,0,0,0,1
User5127,0,1,0,0,0,1
User5128,1,0,0,0,0,1
User5980,0,0,1,0,0,1
User5129,0,0,0,1,0,1
User5039,0,0,0,1,0,1
User6001,0,1,0,0,0,1
User5983,0,1,0,0,0,1
User5081,0,0,1,0,0,1
User6005,0,0,1,0,0,1
User6000,0,0,1,0,0,1
User5057,0,0,1,0,0,1
User6028,0,0,0,0,1,1
User5027,0,0,0,1,0,1
User5007,0,0,1,0,0,1
User5015,0,0,1,0,0,1
User5014,0,1,0,0,0,1
User6013,0,0,1,0,0,1
User5012,0,0,1,0,0,1
User5987,1,0,0,0,0,1
User6025,0,0,1,0,0,1
User5962,0,1,0,0,0,1
User5062,0,1,0,0,0,1
User5988,0,1,0,0,0,1
User5063,0,0,1,0,0,1
User5064,0,0,1,0,0,1
User5006,1,0,0,0,0,1
User6041,0,1,0,0,0,1
User5005,0,1,0,0,0,1
User5065,0,1,0,0,0,1
User5961,0,0,0,1,0,1
User5066,0,0,1,0,0,1
User5004,0,1,0,0,0,1
User5960,0,1,0,0,0,1
User5156,0,0,0,1,0,1
User6014,0,0,1,0,0,1
User6016,0,1,0,0,0,1
User5959,0,0,1,0,0,1
User5997,0,0,1,0,0,1
User5964,0,0,0,0,1,1
User6026,0,1,0,0,0,1
User5965,0,0,1,0,0,1
User5998,0,1,0,0,0,1
User6010,0,1,0,0,0,1
User5058,0,0,1,0,0,1
User5026,0,0,1,0,0,1
User6011,0,1,0,0,0,1
User5099,0,1,0,0,0,1
User5098,0,0,1,0,0,1
User5143,0,0,0,1,0,1
User5097,0,1,0,0,0,1
User5023,0,1,0,0,0,1
User5984,0,0,0,0,1,1
User5967,0,1,0,0,0,1
User5999,0,0,1,0,0,1
User6027,1,0,0,0,0,1
User5094,0,0,0,1,0,1
User5060,0,1,0,0,0,1
User5022,0,1,0,0,0,1
User5061,0,1,0,0,0,1
User5021,0,1,0,0,0,1
User5966,0,1,0,0,0,1
User5020,0,0,0,1,0,1
User5019,0,1,0,0,0,1
User5046,0,0,0,1,0,1
User5147,0,1,0,0,0,1
User5018,0,1,0,0,0,1
User5337,0,0,1,0,0,1
User5946,0,1,0,0,0,1
User5483,0,1,0,0,0,1
User5497,1,0,0,0,0,1
User5496,0,0,1,0,0,1
User5748,0,0,0,1,0,1
User5749,0,0,0,1,0,1
User5492,0,1,0,0,0,1
User5491,0,0,1,0,0,1
User5490,0,1,0,0,0,1
User5489,0,1,0,0,0,1
User5488,0,0,1,0,0,1
User5487,0,0,0,0,1,1
User5486,0,1,0,0,0,1
User5755,0,0,1,0,0,1
User5764,0,0,1,0,0,1
User5756,0,0,1,0,0,1
User5757,0,0,0,0,1,1
User5758,0,0,0,1,0,1
User5482,0,1,0,0,0,1
User5481,0,1,0,0,0,1
User5480,0,0,1,0,0,1
User5759,0,0,1,0,0,1
User5478,0,0,0,1,0,1
User5760,0,0,1,0,0,1
User5761,0,1,0,0,0,1
User5762,0,0,1,0,0,1
User5498,1,0,0,0,0,1
User5747,0,0,0,1,0,1
User5499,0,1,0,0,0,1
User5746,0,0,0,1,0,1
User5728,0,1,0,0,0,1
User5519,0,0,1,0,0,1
User5518,0,0,0,1,0,1
User5730,0,0,1,0,0,1
User5731,0,1,0,0,0,1
User5515,0,0,0,1,0,1
User5732,0,0,1,0,0,1
User5735,0,1,0,0,0,1
User6056,0,1,0,0,0,1
User5737,0,0,1,0,0,1
User5738,0,0,0,1,0,1
User5739,0,1,0,0,0,1
User5509,0,1,0,0,0,1
User5740,0,1,0,0,0,1
User5507,0,1,0,0,0,1
User5506,0,1,0,0,0,1
User5505,1,0,0,0,0,1
User5741,0,0,1,0,0,1
User5504,0,1,0,0,0,1
User5743,0,0,1,0,0,1
User5503,0,0,0,1,0,1
User5501,0,1,0,0,0,1
User5500,0,1,0,0,0,1
User5476,0,0,1,0,0,1
User5766,0,1,0,0,0,1
User5520,0,0,0,1,0,1
User5420,0,0,1,0,0,1
User5787,0,0,0,1,0,1
User5788,0,0,1,0,0,1
User5442,0,1,0,0,0,1
User5790,0,0,1,0,0,1
User5791,0,0,0,1,0,1
User5793,0,0,0,1,0,1
User5794,1,0,0,0,0,1
User5431,0,0,1,0,0,1
User5428,0,1,0,0,0,1
User5425,1,0,0,0,0,1
User5424,0,1,0,0,0,1
User5418,0,0,0,1,0,1
User5768,0,0,1,0,0,1
User5417,0,1,0,0,0,1
User5416,0,0,1,0,0,1
User5414,0,0,1,0,0,1
User5413,0,0,1,0,0,1
User5412,0,0,0,0,1,1
User5799,0,1,0,0,0,1
User5800,0,1,0,0,0,1
User5801,0,1,0,0,0,1
User5409,0,0,1,0,0,1
User6054,0,1,0,0,0,1
User5803,0,0,1,0,0,1
User5786,1,0,0,0,0,1
User5443,0,0,0,1,0,1
User5444,1,0,0,0,0,1
User5445,0,0,0,1,0,1
User5468,0,0,1,0,0,1
User5769,0,0,0,0,1,1
User5770,0,0,1,0,0,1
User5772,0,0,1,0,0,1
User5773,0,0,0,1,0,1
User5464,0,0,1,0,0,1
User5774,0,0,1,0,0,1
User5463,0,1,0,0,0,1
User5775,0,1,0,0,0,1
User5461,0,0,0,1,0,1
User5778,0,0,0,1,0,1
User5458,0,0,1,0,0,1
User5457,0,0,1,0,0,1
User5456,0,0,1,0,0,1
User5455,0,0,0,1,0,1
User5454,0,0,0,1,0,1
User5453,0,1,0,0,0,1
User5452,0,1,0,0,0,1
User5781,1,0,0,0,0,1
User5782,0,0,1,0,0,1
User6055,0,1,0,0,0,1
User5448,0,0,0,1,0,1
User5785,0,0,1,0,0,1
User5727,0,0,1,0,0,1
User5521,0,0,0,1,0,1
User5176,0,1,0,0,0,1
User5586,0,1,0,0,0,1
User5599,0,1,0,0,0,1
User5598,0,0,0,1,0,1
User5654,0,1,0,0,0,1
User5655,1,0,0,0,0,1
User5594,0,0,1,0,0,1
User5656,0,0,1,0,0,1
User5592,0,1,0,0,0,1
User5590,0,1,0,0,0,1
User5659,0,0,0,1,0,1
User5661,0,0,1,0,0,1
User5588,0,0,0,1,0,1
User5664,1,0,0,0,0,1
User5578,0,1,0,0,0,1
User5665,0,1,0,0,0,1
User5583,0,0,1,0,0,1
User5582,0,0,1,0,0,1
User5672,0,0,0,1,0,1
User5673,0,0,0,1,0,1
User5675,0,0,1,0,0,1
User5676,0,0,1,0,0,1
User5677,0,1,0,0,0,1
User5678,0,1,0,0,0,1
User5679,0,1,0,0,0,1
User5680,0,0,1,0,0,1
User5652,0,0,1,0,0,1
User5650,0,1,0,0,0,1
User5649,0,0,1,0,0,1
User5647,0,0,1,0,0,1
User5627,0,0,0,0,1,1
User5629,0,1,0,0,0,1
User5631,0,1,0,0,0,1
User5625,0,0,0,1,0,1
User5624,0,0,0,1,0,1
User5622,0,0,1,0,0,1
User5634,0,1,0,0,0,1
User5635,0,0,1,0,0,1
User5621,0,0,1,0,0,1
User5636,0,0,0,1,0,1
User5637,0,0,1,0,0,1
User5619,0,1,0,0,0,1
User5616,0,1,0,0,0,1
User5640,1,0,0,0,0,1
User5615,0,0,0,1,0,1
User5614,0,0,1,0,0,1
User5610,0,1,0,0,0,1
User5645,0,0,0,1,0,1
User6058,0,1,0,0,0,1
User5607,0,0,1,0,0,1
User5646,0,0,1,0,0,1
User5606,0,1,0,0,0,1
User5605,0,0,1,0,0,1
User5579,0,0,1,0,0,1
User5576,0,0,1,0,0,1
User5523,1,0,0,0,0,1
User6057,0,1,0,0,0,1
User5703,0,1,0,0,0,1
User5704,1,0,0,0,0,1
User5705,1,0,0,0,0,1
User5706,1,0,0,0,0,1
User5707,0,0,1,0,0,1
User5708,0,0,1,0,0,1
User5709,0,0,1,0,0,1
User5545,0,0,1,0,0,1
User5712,0,0,1,0,0,1
User5714,0,0,1,0,0,1
User5541,0,1,0,0,0,1
User5538,0,0,1,0,0,1
User5575,0,0,1,0,0,1
User5715,0,0,0,0,1,1
User5717,0,0,1,0,0,1
User5718,0,1,0,0,0,1
User5720,0,0,0,1,0,1
User5531,0,0,1,0,0,1
User5530,0,1,0,0,0,1
User5723,0,0,1,0,0,1
User5527,0,1,0,0,0,1
User5724,0,0,1,0,0,1
User5524,1,0,0,0,0,1
User5725,1,0,0,0,0,1
User5549,0,1,0,0,0,1
User5551,0,0,0,1,0,1
User5552,0,0,1,0,0,1
User5700,0,1,0,0,0,1
User5574,1,0,0,0,0,1
User5572,0,0,0,1,0,1
User5571,0,0,0,1,0,1
User5682,0,0,0,1,0,1
User5570,0,0,1,0,0,1
User5683,0,0,1,0,0,1
User5568,0,0,1,0,0,1
User5566,0,0,1,0,0,1
User5686,0,0,0,1,0,1
User5688,0,1,0,0,0,1
User5689,0,1,0,0,0,1
User5565,0,1,0,0,0,1
User5690,0,0,0,1,0,1
User5563,0,1,0,0,0,1
User5694,0,1,0,0,0,1
User5560,0,1,0,0,0,1
User5696,0,0,1,0,0,1
User5697,0,0,0,1,0,1
User5557,0,0,0,1,0,1
User5556,0,0,1,0,0,1
User5555,0,1,0,0,0,1
User5698,0,1,0,0,0,1
User5554,0,1,0,0,0,1
User5407,0,1,0,0,0,1
User5406,0,1,0,0,0,1
User5405,0,0,1,0,0,1
User5913,0,0,0,0,1,1
User5256,0,1,0,0,0,1
User5905,0,0,1,0,0,1
User5253,0,0,0,1,0,1
User5252,0,1,0,0,0,1
User5910,0,0,1,0,0,1
User5249,0,1,0,0,0,1
User5248,0,1,0,0,0,1
User5246,0,1,0,0,0,1
User5912,0,1,0,0,0,1
User5245,0,0,1,0,0,1
User5244,0,0,1,0,0,1
User5243,0,1,0,0,0,1
User5232,0,1,0,0,0,1
User5914,1,0,0,0,0,1
User5242,1,0,0,0,0,1
User5241,0,0,1,0,0,1
User5240,0,1,0,0,0,1
User5239,0,1,0,0,0,1
User5916,0,0,1,0,0,1
User5237,0,1,0,0,0,1
User6049,1,0,0,0,0,1
User5234,0,0,1,0,0,1
User6048,1,0,0,0,0,1
User5233,0,0,0,1,0,1
User5904,0,0,1,0,0,1
User5903,0,0,1,0,0,1
User5258,1,0,0,0,0,1
User5259,0,1,0,0,0,1
User5283,0,1,0,0,0,1
User5282,0,1,0,0,0,1
User5281,0,0,0,0,1,1
User5280,0,0,1,0,0,1
User5279,0,0,0,1,0,1
User5886,0,0,0,1,0,1
User5278,1,0,0,0,0,1
User5276,0,0,0,1,0,1
User5888,0,1,0,0,0,1
User5889,0,0,1,0,0,1
User5890,0,0,1,0,0,1
User5891,0,0,1,0,0,1
User6051,0,0,1,0,0,1
User6050,0,1,0,0,0,1
User5893,0,1,0,0,0,1
User5271,0,0,1,0,0,1
User5895,1,0,0,0,0,1
User5268,0,0,0,1,0,1
User5267,0,0,1,0,0,1
User5898,0,1,0,0,0,1
User5263,0,1,0,0,0,1
User5900,0,0,1,0,0,1
User5260,0,0,1,0,0,1
User6047,0,0,0,1,0,1
User6045,0,1,0,0,0,1
User5404,0,1,0,0,0,1
User5186,0,1,0,0,0,1
User5201,0,0,1,0,0,1
User5936,0,0,1,0,0,1
User5937,1,0,0,0,0,1
User5938,0,0,0,1,0,1
User5939,1,0,0,0,0,1
User6043,0,1,0,0,0,1
User5196,0,1,0,0,0,1
User5190,0,1,0,0,0,1
User5189,0,1,0,0,0,1
User5188,0,0,1,0,0,1
User5187,0,0,1,0,0,1
User5185,0,0,0,1,0,1
User5922,0,0,1,0,0,1
User5184,0,1,0,0,0,1
User5183,0,0,1,0,0,1
User5182,0,1,0,0,0,1
User5181,0,1,0,0,0,1
User5940,0,1,0,0,0,1
User5941,1,0,0,0,0,1
User5942,1,0,0,0,0,1
User5178,0,1,0,0,0,1
User5177,0,0,1,0,0,1
User5943,0,0,0,1,0,1
User5944,1,0,0,0,0,1
User5202,0,0,1,0,0,1
User5203,0,0,1,0,0,1
User5935,0,1,0,0,0,1
User5205,0,1,0,0,0,1
User5229,0,1,0,0,0,1
User5228,0,1,0,0,0,1
User5923,0,0,1,0,0,1
User5227,0,1,0,0,0,1
User5226,0,1,0,0,0,1
User5224,0,1,0,0,0,1
User5222,0,1,0,0,0,1
User5221,0,0,0,0,1,1
User5925,1,0,0,0,0,1
User5218,0,0,0,0,1,1
User5926,0,1,0,0,0,1
User5216,0,0,1,0,0,1
User6044,0,0,1,0,0,1
User5215,0,1,0,0,0,1
User5927,0,0,1,0,0,1
User5928,0,1,0,0,0,1
User5211,0,1,0,0,0,1
User5930,0,0,0,1,0,1
User5931,0,1,0,0,0,1
User5932,1,0,0,0,0,1
User5210,0,0,0,1,0,1
User5933,0,0,0,1,0,1
User5934,0,1,0,0,0,1
User5285,0,0,1,0,0,1
User5883,0,0,0,0,1,1
User5287,0,0,0,1,0,1
User5360,0,1,0,0,0,1
User5832,0,1,0,0,0,1
User5377,0,0,1,0,0,1
User5376,0,0,0,1,0,1
User5375,0,0,0,1,0,1
User5374,0,1,0,0,0,1
User5370,0,0,0,1,0,1
User5369,0,0,1,0,0,1
User5835,0,1,0,0,0,1
User5365,0,1,0,0,0,1
User5363,0,0,1,0,0,1
User5361,1,0,0,0,0,1
User5837,0,0,0,1,0,1
User5291,0,1,0,0,0,1
User5838,1,0,0,0,0,1
User5841,0,1,0,0,0,1
User5842,0,0,1,0,0,1
User5359,0,1,0,0,0,1
User5358,0,1,0,0,0,1
User5357,0,0,1,0,0,1
User5845,0,0,1,0,0,1
User5847,0,1,0,0,0,1
User5353,0,0,1,0,0,1
User5848,0,0,1,0,0,1
User5352,0,0,1,0,0,1
User5831,0,0,1,0,0,1
User5830,0,0,0,1,0,1
User5382,0,0,1,0,0,1
User5383,0,1,0,0,0,1
User5403,0,0,1,0,0,1
User5402,0,0,1,0,0,1
User5807,0,0,1,0,0,1
User5811,0,1,0,0,0,1
User5812,0,0,0,1,0,1
User5400,0,0,1,0,0,1
User5399,0,1,0,0,0,1
User5398,0,1,0,0,0,1
User5397,0,1,0,0,0,1
User5396,0,0,1,0,0,1
User5395,0,0,0,1,0,1
User5394,1,0,0,0,0,1
User5816,0,0,1,0,0,1
User5817,0,0,1,0,0,1
User5818,0,1,0,0,0,1
User5391,0,0,0,1,0,1
User5390,0,0,1,0,0,1
User5821,0,1,0,0,0,1
User5822,0,0,1,0,0,1
User5387,0,0,0,1,0,1
User5826,0,0,1,0,0,1
User5385,0,0,1,0,0,1
User5827,0,1,0,0,0,1
User5349,0,1,0,0,0,1
User5347,0,1,0,0,0,1
User5345,0,1,0,0,0,1
User5321,0,0,1,0,0,1
User5319,0,1,0,0,0,1
User5318,0,1,0,0,0,1
User5317,0,0,0,1,0,1
User5316,0,1,0,0,0,1
User5873,0,0,1,0,0,1
User5874,0,0,0,1,0,1
User5315,0,0,0,1,0,1
User5313,0,1,0,0,0,1
User5312,0,1,0,0,0,1
User5311,0,1,0,0,0,1
User5875,0,0,0,1,0,1
User5876,0,0,0,1,0,1
User5878,1,0,0,0,0,1
User5306,0,1,0,0,0,1
User5303,0,0,1,0,0,1
User6053,0,1,0,0,0,1
User5300,0,0,0,1,0,1
User5298,0,0,1,0,0,1
User5297,0,0,0,1,0,1
User5296,1,0,0,0,0,1
User5295,0,1,0,0,0,1
User5294,0,0,1,0,0,1
User5292,0,1,0,0,0,1
User5872,0,0,1,0,0,1
User5871,0,0,0,1,0,1
User5342,0,0,0,1,0,1
User5870,0,1,0,0,0,1
User5341,0,1,0,0,0,1
User5853,1,0,0,0,0,1
User5854,0,0,0,1,0,1
User5856,0,0,0,1,0,1
User5340,0,0,1,0,0,1
User5339,0,0,1,0,0,1
User5338,0,1,0,0,0,1
User5335,0,0,1,0,0,1
User5334,0,1,0,0,0,1
User5333,0,1,0,0,0,1
User5859,0,0,1,0,0,1
User5331,0,0,1,0,0,1
User5330,0,1,0,0,0,1
User5863,0,0,0,1,0,1
User5864,0,0,0,1,0,1
User5326,0,0,0,1,0,1
User5325,0,0,0,1,0,1
User5865,0,1,0,0,0,1
User5866,0,0,1,0,0,1
User5324,0,1,0,0,0,1
User5323,0,0,0,1,0,1
User5869,0,0,1,0,0,1
User5322,0,0,0,1,0,1
User6023,0,1,0,0,0,1
User3031,1,0,0,0,0,1
User4982,0,0,1,0,0,1
User3029,0,0,1,0,0,1
User3103,0,0,0,1,0,1
User3102,0,0,1,0,0,1
User3098,0,0,0,1,0,1
User3088,0,1,0,0,0,1
User3087,1,0,0,0,0,1
User3080,0,0,0,1,0,1
User3076,0,0,0,1,0,1
User3074,0,1,0,0,0,1
User3067,0,0,1,0,0,1
User3063,0,0,1,0,0,1
User3053,0,0,0,1,0,1
User3045,0,0,1,0,0,1
User3035,0,1,0,0,0,1
User3034,0,0,0,1,0,1
User3028,0,1,0,0,0,1
User3113,1,0,0,0,0,1
User3026,0,0,1,0,0,1
User3025,0,0,0,1,0,1
User3021,0,0,1,0,0,1
User3015,0,1,0,0,0,1
User3006,0,0,0,1,0,1
User3004,0,1,0,0,0,1
User2995,0,0,0,1,0,1
User2994,0,0,1,0,0,1
User2984,0,0,0,1,0,1
User2981,1,0,0,0,0,1
User2976,0,0,0,1,0,1
User2975,0,0,0,1,0,1
User2972,0,0,0,1,0,1
User2967,1,0,0,0,0,1
User3108,0,1,0,0,0,1
User3116,0,0,0,0,1,1
User3223,0,0,0,1,0,1
User3164,0,1,0,0,0,1
User3218,0,1,0,0,0,1
User3214,0,1,0,0,0,1
User3208,0,1,0,0,0,1
User3195,0,0,0,1,0,1
User3192,0,1,0,0,0,1
User3179,0,0,0,1,0,1
User3178,1,0,0,0,0,1
User3176,0,0,1,0,0,1
User3174,0,0,0,1,0,1
User3173,0,0,1,0,0,1
User3170,0,0,0,1,0,1
User3169,0,0,0,1,0,1
User3168,0,0,0,1,0,1
User3167,0,0,0,1,0,1
User3160,0,0,0,1,0,1
User3119,1,0,0,0,0,1
User3159,0,0,1,0,0,1
User3158,0,0,1,0,0,1
User3157,0,0,1,0,0,1
User3154,0,1,0,0,0,1
User3153,0,1,0,0,0,1
User3152,0,1,0,0,0,1
User3146,0,1,0,0,0,1
User3142,0,1,0,0,0,1
User3139,0,1,0,0,0,1
User3136,0,0,0,1,0,1
User3134,0,1,0,0,0,1
User3131,0,0,0,1,0,1
User3129,0,0,0,1,0,1
User3123,0,0,0,1,0,1
User2965,0,0,0,1,0,1
User2961,0,0,0,1,0,1
User2957,0,1,0,0,0,1
User2740,0,1,0,0,0,1
User2802,0,0,0,1,0,1
User2800,0,1,0,0,0,1
User2798,0,0,1,0,0,1
User2794,0,0,0,1,0,1
User2791,0,0,0,1,0,1
User2789,0,0,1,0,0,1
User2783,0,0,0,1,0,1
User2770,0,1,0,0,0,1
User2769,0,0,0,1,0,1
User2761,0,1,0,0,0,1
User2757,0,1,0,0,0,1
User2755,0,0,0,1,0,1
User2752,0,0,0,1,0,1
User2749,0,0,0,1,0,1
User2738,1,0,0,0,0,1
User2941,0,0,1,0,0,1
User2735,0,0,0,1,0,1
User2726,0,1,0,0,0,1
User2724,1,0,0,0,0,1
User2720,0,1,0,0,0,1
User2719,1,0,0,0,0,1
User2718,1,0,0,0,0,1
User2704,0,0,1,0,0,1
User2701,0,0,0,1,0,1
User2691,0,0,0,1,0,1
User2673,0,0,0,1,0,1
User2671,0,0,0,1,0,1
User2657,0,1,0,0,0,1
User2656,0,0,0,1,0,1
User2651,1,0,0,0,0,1
User2805,0,0,0,1,0,1
User2808,0,0,1,0,0,1
User2810,0,0,1,0,0,1
User2811,0,0,0,1,0,1
User2940,0,0,0,1,0,1
User2928,0,1,0,0,0,1
User2922,0,1,0,0,0,1
User2918,0,0,0,1,0,1
User2916,0,0,0,1,0,1
User2913,0,0,0,1,0,1
User2906,0,1,0,0,0,1
User2905,0,1,0,0,0,1
User2904,0,1,0,0,0,1
User2900,0,0,0,1,0,1
User2895,0,1,0,0,0,1
User2894,0,1,0,0,0,1
User2889,0,0,1,0,0,1
User2888,0,0,1,0,0,1
User2882,0,0,1,0,0,1
User2879,0,0,1,0,0,1
User2878,0,1,0,0,0,1
User2877,0,0,0,1,0,1
User2876,0,0,0,1,0,1
User2864,0,0,0,1,0,1
User2861,0,1,0,0,0,1
User2853,0,1,0,0,0,1
User2846,0,0,1,0,0,1
User2843,0,0,0,1,0,1
User2840,0,1,0,0,0,1
User2834,0,0,0,1,0,1
User2830,1,0,0,0,0,1
User2818,0,0,0,1,0,1
User2812,0,0,0,1,0,1
User3222,1,0,0,0,0,1
User3224,0,0,0,0,1,1
User2637,0,0,0,1,0,1
User3487,0,0,0,0,1,1
User3521,0,0,1,0,0,1
User3517,0,0,1,0,0,1
User3516,0,1,0,0,0,1
User3513,0,0,0,1,0,1
User3511,0,0,1,0,0,1
User3509,0,0,0,1,0,1
User3508,0,0,1,0,0,1
User3504,0,0,0,1,0,1
User3497,0,1,0,0,0,1
User3496,0,1,0,0,0,1
User3495,0,1,0,0,0,1
User3494,1,0,0,0,0,1
User3492,0,1,0,0,0,1
User3488,0,0,1,0,0,1
User3486,0,1,0,0,0,1
User3527,0,0,0,1,0,1
User3484,0,0,0,1,0,1
User3483,1,0,0,0,0,1
User3482,1,0,0,0,0,1
User3481,0,0,1,0,0,1
User3479,0,0,0,1,0,1
User3478,0,0,1,0,0,1
User3468,0,0,1,0,0,1
User3457,0,1,0,0,0,1
User3454,0,0,0,1,0,1
User3453,0,0,1,0,0,1
User3451,0,1,0,0,0,1
User3448,0,0,0,1,0,1
User3446,0,0,1,0,0,1
User3438,0,0,0,1,0,1
User3524,0,0,1,0,0,1
User3531,0,1,0,0,0,1
User3230,0,0,1,0,0,1
User3594,0,0,1,0,0,1
User3631,0,0,1,0,0,1
User3630,0,0,1,0,0,1
User3625,0,0,1,0,0,1
User3623,0,0,0,1,0,1
User3621,0,0,0,1,0,1
User3620,0,0,0,1,0,1
User3617,0,0,0,1,0,1
User3614,0,1,0,0,0,1
User3613,0,1,0,0,0,1
User3608,0,0,0,0,1,1
User3607,0,0,1,0,0,1
User3605,0,0,0,1,0,1
User3603,0,0,0,1,0,1
User3602,0,0,0,1,0,1
User3590,1,0,0,0,0,1
User3535,0,0,0,1,0,1
User3586,0,0,0,1,0,1
User3585,0,0,0,1,0,1
User3584,0,1,0,0,0,1
User3581,0,0,0,1,0,1
User3575,0,0,1,0,0,1
User3573,0,0,1,0,0,1
User3564,0,1,0,0,0,1
User3558,0,0,0,1,0,1
User3555,1,0,0,0,0,1
User3549,1,0,0,0,0,1
User3548,0,1,0,0,0,1
User3547,1,0,0,0,0,1
User3545,0,0,0,1,0,1
User3543,0,0,1,0,0,1
User3435,0,0,1,0,0,1
User3428,0,0,1,0,0,1
User3422,0,1,0,0,0,1
User3287,1,0,0,0,0,1
User3339,0,0,0,1,0,1
User3336,0,0,0,1,0,1
User3321,0,1,0,0,0,1
User3319,0,0,0,1,0,1
User3316,0,0,0,1,0,1
User3314,0,0,0,1,0,1
User3313,0,0,1,0,0,1
User3312,0,1,0,0,0,1
User3308,0,0,1,0,0,1
User3305,0,0,1,0,0,1
User3303,0,0,0,1,0,1
User3300,0,0,0,1,0,1
User3297,0,1,0,0,0,1
User3289,1,0,0,0,0,1
User3284,0,0,0,1,0,1
User3420,0,1,0,0,0,1
User3280,0,0,0,1,0,1
User3278,1,0,0,0,0,1
User3276,0,1,0,0,0,1
User3268,0,1,0,0,0,1
User3266,0,0,0,1,0,1
User3262,1,0,0,0,0,1
User3258,0,0,1,0,0,1
User3257,0,0,0,1,0,1
User3252,0,0,1,0,0,1
User3241,0,0,1,0,0,1
User3236,0,0,0,1,0,1
User3235,0,0,0,1,0,1
User3234,0,1,0,0,0,1
User3231,0,1,0,0,0,1
User3340,0,0,0,1,0,1
User3341,0,0,1,0,0,1
User3342,0,0,1,0,0,1
User3345,0,0,0,1,0,1
User3418,0,0,1,0,0,1
User3414,0,0,1,0,0,1
User3413,0,1,0,0,0,1
User3409,0,0,0,1,0,1
User3408,0,0,1,0,0,1
User3407,0,1,0,0,0,1
User3404,1,0,0,0,0,1
User3403,0,0,0,1,0,1
User3401,0,0,1,0,0,1
User3400,0,0,0,0,1,1
User3398,0,0,0,1,0,1
User3391,0,1,0,0,0,1
User3388,0,0,0,1,0,1
User3386,0,1,0,0,0,1
User3385,0,0,0,0,1,1
User3382,0,1,0,0,0,1
User3381,0,1,0,0,0,1
User3377,0,0,1,0,0,1
User3376,0,1,0,0,0,1
User3373,0,0,0,1,0,1
User3369,0,0,0,1,0,1
User3367,0,0,0,1,0,1
User3363,0,0,1,0,0,1
User3362,0,0,0,0,1,1
User3360,0,1,0,0,0,1
User3359,0,0,1,0,0,1
User3357,1,0,0,0,0,1
User3355,1,0,0,0,0,1
User3353,0,0,0,1,0,1
User2646,0,1,0,0,0,1
User2634,0,0,0,1,0,1
User4980,1,0,0,0,0,1
User1369,0,0,1,0,0,1
User1490,0,1,0,0,0,1
User1480,0,1,0,0,0,1
User1475,0,0,0,1,0,1
User1470,0,0,0,1,0,1
User1455,0,0,0,1,0,1
User1424,0,0,0,1,0,1
User1419,0,0,0,1,0,1
User1417,0,0,1,0,0,1
User1410,0,0,1,0,0,1
User1409,0,0,1,0,0,1
User1402,0,0,0,1,0,1
User1387,0,0,1,0,0,1
User1383,1,0,0,0,0,1
User1378,0,0,0,1,0,1
User1358,0,0,0,1,0,1
User1503,0,0,0,1,0,1
User1351,0,0,0,1,0,1
User1350,0,0,0,1,0,1
User1348,1,0,0,0,0,1
User1346,0,0,0,1,0,1
User1340,0,0,0,1,0,1
User1324,0,1,0,0,0,1
User1319,1,0,0,0,0,1
User1314,0,0,0,1,0,1
User1312,0,1,0,0,0,1
User1307,1,0,0,0,0,1
User1299,0,0,0,1,0,1
User1262,0,0,1,0,0,1
User1237,0,0,0,1,0,1
User1233,1,0,0,0,0,1
User1495,0,0,0,1,0,1
User1513,0,0,0,1,0,1
User1769,0,0,0,1,0,1
User1633,0,1,0,0,0,1
User1751,0,0,0,1,0,1
User1748,0,0,1,0,0,1
User1740,0,0,0,1,0,1
User1739,0,0,0,1,0,1
User1736,0,1,0,0,0,1
User1734,0,0,1,0,0,1
User1731,0,0,0,1,0,1
User1725,0,1,0,0,0,1
User1720,0,0,0,1,0,1
User1701,1,0,0,0,0,1
User1696,0,1,0,0,0,1
User1641,0,1,0,0,0,1
User1637,1,0,0,0,0,1
User1635,0,1,0,0,0,1
User1626,0,0,0,1,0,1
User1522,1,0,0,0,0,1
User1624,0,1,0,0,0,1
User1602,0,0,0,1,0,1
User1590,1,0,0,0,0,1
User1589,1,0,0,0,0,1
User1584,0,0,0,1,0,1
User1582,0,0,0,1,0,1
User1579,1,0,0,0,0,1
User1563,0,0,0,1,0,1
User1553,0,1,0,0,0,1
User1549,0,0,0,1,0,1
User1545,0,0,0,1,0,1
User1538,0,0,0,1,0,1
User1530,0,0,1,0,0,1
User1524,0,0,1,0,0,1
User1226,0,0,0,1,0,1
User1215,0,0,0,1,0,1
User1214,0,0,1,0,0,1
User570,1,0,0,0,0,1
User851,0,0,0,1,0,1
User850,0,0,0,1,0,1
User823,1,0,0,0,0,1
User819,0,0,0,1,0,1
User814,0,1,0,0,0,1
User801,0,1,0,0,0,1
User794,0,0,1,0,0,1
User789,1,0,0,0,0,1
User783,0,0,0,1,0,1
User777,1,0,0,0,0,1
User723,1,0,0,0,0,1
User699,0,0,0,1,0,1
User616,0,0,0,1,0,1
User594,0,0,1,0,0,1
User544,1,0,0,0,0,1
User1213,0,0,0,1,0,1
User531,0,0,0,1,0,1
User528,0,1,0,0,0,1
User521,0,0,0,0,1,1
User510,0,1,0,0,0,1
User451,1,0,0,0,0,1
User450,1,0,0,0,0,1
User426,0,0,0,1,0,1
User417,0,0,0,1,0,1
User267,0,0,0,1,0,1
User224,0,0,1,0,0,1
User189,0,0,1,0,0,1
User157,0,0,1,0,0,1
User139,0,0,0,1,0,1
User37,0,0,0,1,0,1
User862,0,0,0,1,0,1
User863,1,0,0,0,0,1
User870,0,0,0,1,0,1
User888,0,0,0,1,0,1
User1202,0,1,0,0,0,1
User1194,0,1,0,0,0,1
User1187,0,0,1,0,0,1
User1167,0,0,1,0,0,1
User1162,0,0,0,0,1,1
User1145,0,1,0,0,0,1
User1140,0,1,0,0,0,1
User1112,0,1,0,0,0,1
User1107,0,0,0,1,0,1
User1103,0,0,0,1,0,1
User1093,1,0,0,0,0,1
User1089,0,1,0,0,0,1
User1084,0,0,1,0,0,1
User1070,0,1,0,0,0,1
User1068,0,0,0,1,0,1
User1026,0,1,0,0,0,1
User1025,0,1,0,0,0,1
User1010,0,1,0,0,0,1
User1004,0,1,0,0,0,1
User1003,0,0,1,0,0,1
User990,0,0,0,0,1,1
User983,0,1,0,0,0,1
User977,0,1,0,0,0,1
User971,0,1,0,0,0,1
User964,0,0,0,1,0,1
User953,0,0,0,1,0,1
User936,0,0,1,0,0,1
User923,0,1,0,0,0,1
User894,1,0,0,0,0,1
User1767,0,0,0,1,0,1
User1795,1,0,0,0,0,1
User2630,0,0,0,1,0,1
User2288,0,0,0,1,0,1
User2402,0,1,0,0,0,1
User2395,0,0,1,0,0,1
User2383,1,0,0,0,0,1
User2381,0,0,0,1,0,1
User2380,0,0,0,1,0,1
User2376,0,0,0,1,0,1
User2342,0,1,0,0,0,1
User2327,0,0,0,1,0,1
User2308,1,0,0,0,0,1
User2304,0,1,0,0,0,1
User2303,0,1,0,0,0,1
User2299,0,0,0,1,0,1
User2297,0,0,0,1,0,1
User2294,0,0,0,1,0,1
User2278,0,0,1,0,0,1
User2417,0,0,0,1,0,1
User2275,0,0,0,1,0,1
User2273,0,0,0,1,0,1
User2268,0,0,1,0,0,1
User2267,0,0,0,1,0,1
User2258,1,0,0,0,0,1
User2244,0,0,0,1,0,1
User2239,0,0,1,0,0,1
User2234,0,0,0,1,0,1
User2233,0,0,0,1,0,1
User2228,0,0,0,1,0,1
User2225,0,0,0,1,0,1
User2224,0,1,0,0,0,1
User2222,0,0,1,0,0,1
User2216,0,0,0,1,0,1
User2407,0,1,0,0,0,1
User2419,0,0,0,1,0,1
User1799,0,1,0,0,0,1
User2495,0,1,0,0,0,1
User2627,0,0,0,1,0,1
User2619,0,1,0,0,0,1
User2606,0,1,0,0,0,1
User2582,0,1,0,0,0,1
User2580,1,0,0,0,0,1
User2564,0,0,0,1,0,1
User2554,0,1,0,0,0,1
User2552,0,1,0,0,0,1
User2527,0,0,0,1,0,1
User2525,0,0,0,1,0,1
User2522,0,0,0,1,0,1
User2514,0,0,0,1,0,1
User2512,0,0,0,1,0,1
User2498,0,0,0,0,1,1
User2494,0,1,0,0,0,1
User2422,1,0,0,0,0,1
User2490,0,0,1,0,0,1
User2489,1,0,0,0,0,1
User2477,0,0,0,1,0,1
User2472,0,0,0,1,0,1
User2466,0,0,1,0,0,1
User2460,0,0,0,1,0,1
User2448,0,0,0,1,0,1
User2447,0,0,0,1,0,1
User2441,0,0,0,1,0,1
User2435,0,0,0,1,0,1
User2434,0,1,0,0,0,1
User2432,0,0,0,1,0,1
User2428,0,1,0,0,0,1
User2427,0,1,0,0,0,1
User2212,0,0,0,1,0,1
User2206,0,0,0,1,0,1
User2200,0,0,0,0,1,1
User1929,0,1,0,0,0,1
User2015,0,0,0,1,0,1
User2011,0,0,0,1,0,1
User2009,0,0,1,0,0,1
User2007,0,1,0,0,0,1
User2006,0,0,0,1,0,1
User2004,0,0,0,1,0,1
User1994,0,0,1,0,0,1
User1988,0,0,1,0,0,1
User1980,0,0,0,1,0,1
User1970,0,0,0,1,0,1
User1962,0,1,0,0,0,1
User1948,0,1,0,0,0,1
User1937,0,0,0,1,0,1
User1932,0,0,0,1,0,1
User1913,0,0,0,1,0,1
User2193,0,0,0,1,0,1
User1907,0,0,0,1,0,1
User1892,0,0,0,1,0,1
User1886,0,0,0,1,0,1
User1866,0,1,0,0,0,1
User1865,1,0,0,0,0,1
User1861,0,1,0,0,0,1
User1858,0,1,0,0,0,1
User1856,0,0,0,1,0,1
User1855,1,0,0,0,0,1
User1841,0,0,1,0,0,1
User1840,0,0,0,1,0,1
User1819,0,0,0,1,0,1
User1818,0,0,0,1,0,1
User1802,0,0,0,1,0,1
User2019,0,0,1,0,0,1
User2022,0,0,0,1,0,1
User2023,0,0,0,1,0,1
User2030,0,0,0,1,0,1
User2192,0,1,0,0,0,1
User2191,0,0,1,0,0,1
User2190,1,0,0,0,0,1
User2179,0,0,1,0,0,1
User2176,0,1,0,0,0,1
User2172,0,1,0,0,0,1
User2170,0,1,0,0,0,1
User2167,0,0,0,1,0,1
User2164,0,1,0,0,0,1
User2162,0,1,0,0,0,1
User2158,0,0,0,1,0,1
User2150,0,0,1,0,0,1
User2147,0,0,0,1,0,1
User2142,0,0,0,1,0,1
User2140,1,0,0,0,0,1
User2136,0,1,0,0,0,1
User2133,0,0,1,0,0,1
User2124,0,0,0,1,0,1
User2117,0,0,0,1,0,1
User2100,0,0,0,1,0,1
User2090,0,0,0,1,0,1
User2083,0,0,0,1,0,1
User2072,0,1,0,0,0,1
User2070,0,1,0,0,0,1
User2065,0,1,0,0,0,1
User2044,0,0,0,1,0,1
User2040,1,0,0,0,0,1
User2037,0,0,0,1,0,1
User2031,0,0,0,1,0,1
User3636,0,0,1,0,0,1
User3638,0,1,0,0,0,1
User3639,0,0,1,0,0,1
User4558,0,1,0,0,0,1
User4596,0,0,0,1,0,1
User4595,0,0,1,0,0,1
User4592,0,0,1,0,0,1
User4590,0,0,1,0,0,1
User4587,0,0,1,0,0,1
User4586,0,0,0,1,0,1
User4584,0,1,0,0,0,1
User4578,0,1,0,0,0,1
User4576,0,0,0,1,0,1
User4575,0,0,0,1,0,1
User4570,0,0,1,0,0,1
User4562,0,1,0,0,0,1
User4561,0,1,0,0,0,1
User4560,0,1,0,0,0,1
User4554,0,0,1,0,0,1
User4599,0,0,1,0,0,1
User4552,0,0,0,1,0,1
User4549,0,0,0,1,0,1
User4548,0,0,1,0,0,1
User4544,0,1,0,0,0,1
User4541,0,1,0,0,0,1
User4538,0,0,1,0,0,1
User4537,1,0,0,0,0,1
User4533,1,0,0,0,0,1
User4531,0,0,1,0,0,1
User4529,0,0,1,0,0,1
User4528,1,0,0,0,0,1
User4525,0,1,0,0,0,1
User4516,0,1,0,0,0,1
User4514,0,1,0,0,0,1
User4598,0,0,1,0,0,1
User4600,0,1,0,0,0,1
User4679,0,1,0,0,0,1
User4646,0,0,1,0,0,1
User4677,0,0,1,0,0,1
User4675,0,0,0,1,0,1
User4674,0,0,1,0,0,1
User4673,0,1,0,0,0,1
User4672,0,1,0,0,0,1
User4667,0,0,1,0,0,1
User4665,0,0,0,1,0,1
User4658,0,0,1,0,0,1
User4657,0,1,0,0,0,1
User4656,0,0,0,1,0,1
User4654,0,0,0,1,0,1
User4653,0,0,0,1,0,1
User4651,0,0,1,0,0,1
User4648,0,0,1,0,0,1
User4641,0,0,0,0,1,1
User4602,0,0,1,0,0,1
User4640,1,0,0,0,0,1
User4639,0,0,0,0,1,1
User4638,0,0,0,1,0,1
User4636,0,0,0,1,0,1
User4629,0,0,0,1,0,1
User4628,0,0,0,1,0,1
User4626,0,0,1,0,0,1
User4622,0,0,1,0,0,1
User4621,0,0,0,1,0,1
User4618,0,0,1,0,0,1
User4612,0,0,0,1,0,1
User4611,0,1,0,0,0,1
User4610,0,0,1,0,0,1
User4605,0,0,0,0,1,1
User4512,0,1,0,0,0,1
User4509,0,0,0,1,0,1
User4508,0,1,0,0,0,1
User4395,0,0,1,0,0,1
User4426,0,0,0,1,0,1
User4425,0,0,0,1,0,1
User4424,0,0,0,1,0,1
User4421,0,0,1,0,0,1
User4420,0,1,0,0,0,1
User4419,0,0,1,0,0,1
User4418,0,0,1,0,0,1
User4415,1,0,0,0,0,1
User4414,0,0,0,1,0,1
User4412,0,0,0,1,0,1
User4406,0,0,0,1,0,1
User4405,0,0,1,0,0,1
User4402,0,0,0,1,0,1
User4398,0,0,0,1,0,1
User4391,0,0,1,0,0,1
User4506,0,0,1,0,0,1
User4390,0,0,1,0,0,1
User4389,0,0,0,1,0,1
User4388,0,0,1,0,0,1
User4384,0,0,1,0,0,1
User4382,1,0,0,0,0,1
User4381,0,0,1,0,0,1
User4375,1,0,0,0,0,1
User4371,1,0,0,0,0,1
User4369,0,1,0,0,0,1
User4363,0,1,0,0,0,1
User4362,0,0,0,1,0,1
User4359,1,0,0,0,0,1
User4358,0,1,0,0,0,1
User4357,0,0,0,1,0,1
User4428,0,1,0,0,0,1
User4429,0,0,1,0,0,1
User4431,0,0,0,1,0,1
User4433,0,0,0,1,0,1
User4503,0,0,1,0,0,1
User4501,0,0,0,1,0,1
User4500,0,1,0,0,0,1
User4495,0,0,0,1,0,1
User4494,0,1,0,0,0,1
User4493,0,0,0,1,0,1
User4490,0,0,1,0,0,1
User4488,0,0,1,0,0,1
User4487,0,0,1,0,0,1
User4485,0,0,1,0,0,1
User4477,0,0,1,0,0,1
User4475,0,0,1,0,0,1
User4471,0,0,1,0,0,1
User4468,0,1,0,0,0,1
User4464,1,0,0,0,0,1
User4463,0,1,0,0,0,1
User4462,0,0,1,0,0,1
User4461,0,0,1,0,0,1
User4459,0,0,0,1,0,1
User4457,0,0,1,0,0,1
User4453,0,0,1,0,0,1
User4452,1,0,0,0,0,1
User4451,0,0,0,1,0,1
User4444,0,0,1,0,0,1
User4443,0,0,1,0,0,1
User4442,0,1,0,0,0,1
User4441,0,1,0,0,0,1
User4440,0,0,1,0,0,1
User4435,0,0,0,1,0,1
User4678,0,0,0,1,0,1
User4682,0,0,0,1,0,1
User3643,0,0,0,1,0,1
User4879,0,0,1,0,0,1
User4909,0,0,0,0,1,1
User4908,0,1,0,0,0,1
User4907,0,0,0,1,0,1
User4906,0,0,1,0,0,1
User4901,0,1,0,0,0,1
User4900,0,0,0,1,0,1
User4899,1,0,0,0,0,1
User4896,0,1,0,0,0,1
User4893,0,1,0,0,0,1
User4892,0,1,0,0,0,1
User4889,0,0,1,0,0,1
User4887,0,1,0,0,0,1
User4885,0,1,0,0,0,1
User4882,0,1,0,0,0,1
User4876,0,0,1,0,0,1
User4911,0,0,1,0,0,1
User4875,0,1,0,0,0,1
User4872,0,0,1,0,0,1
User4870,0,0,0,1,0,1
User4865,0,0,1,0,0,1
User4863,0,0,1,0,0,1
User4861,0,0,0,1,0,1
User4856,1,0,0,0,0,1
User4854,0,0,1,0,0,1
User4853,0,1,0,0,0,1
User4851,0,1,0,0,0,1
User4850,0,1,0,0,0,1
User4846,0,0,0,1,0,1
User4843,0,0,1,0,0,1
User4840,0,1,0,0,0,1
User4910,0,1,0,0,0,1
User4912,0,1,0,0,0,1
User4683,0,1,0,0,0,1
User4942,0,1,0,0,0,1
User4979,0,1,0,0,0,1
User4977,0,1,0,0,0,1
User4975,1,0,0,0,0,1
User4972,0,0,0,1,0,1
User4970,0,0,1,0,0,1
User4968,0,1,0,0,0,1
User4965,0,0,0,1,0,1
User4964,0,0,0,1,0,1
User4963,0,0,0,1,0,1
User4953,0,1,0,0,0,1
User4952,0,1,0,0,0,1
User4945,0,1,0,0,0,1
User4944,0,0,0,1,0,1
User4943,0,0,1,0,0,1
User4940,0,1,0,0,0,1
User4915,0,0,1,0,0,1
User4936,1,0,0,0,0,1
User4935,0,1,0,0,0,1
User4934,0,0,1,0,0,1
User4933,0,0,0,1,0,1
User4932,0,1,0,0,0,1
User4931,0,1,0,0,0,1
User4930,0,1,0,0,0,1
User4928,0,0,0,1,0,1
User4926,0,0,1,0,0,1
User4925,0,0,0,1,0,1
User4922,0,0,1,0,0,1
User4921,0,0,0,1,0,1
User4918,0,1,0,0,0,1
User4916,0,0,0,1,0,1
User4839,0,1,0,0,0,1
User4837,0,1,0,0,0,1
User4833,0,1,0,0,0,1
User4712,0,1,0,0,0,1
User4751,0,1,0,0,0,1
User4750,0,0,1,0,0,1
User4748,0,1,0,0,0,1
User4745,0,0,0,1,0,1
User4740,1,0,0,0,0,1
User4738,0,1,0,0,0,1
User4734,0,0,1,0,0,1
User4728,0,0,0,1,0,1
User4719,0,0,1,0,0,1
User4717,0,1,0,0,0,1
User4716,1,0,0,0,0,1
User4715,0,1,0,0,0,1
User4714,0,0,0,1,0,1
User4713,0,0,0,1,0,1
User4711,1,0,0,0,0,1
User4831,0,1,0,0,0,1
User4709,0,0,1,0,0,1
User4706,0,1,0,0,0,1
User4703,0,0,0,1,0,1
User4701,0,0,0,1,0,1
User4700,0,1,0,0,0,1
User4699,0,1,0,0,0,1
User4697,0,0,1,0,0,1
User4696,0,1,0,0,0,1
User4695,0,1,0,0,0,1
User4694,0,1,0,0,0,1
User4692,0,1,0,0,0,1
User4689,0,0,0,1,0,1
User4687,0,1,0,0,0,1
User4684,0,1,0,0,0,1
User4753,0,1,0,0,0,1
User4756,0,0,0,1,0,1
User4757,1,0,0,0,0,1
User4758,0,0,1,0,0,1
User4828,0,0,0,1,0,1
User4825,0,0,0,1,0,1
User4822,0,0,0,0,1,1
User4821,0,0,0,1,0,1
User4811,0,0,1,0,0,1
User4808,0,0,0,1,0,1
User4804,0,0,0,1,0,1
User4801,0,1,0,0,0,1
User4800,0,0,0,1,0,1
User4795,0,0,0,1,0,1
User4793,0,0,0,1,0,1
User4792,0,0,0,1,0,1
User4791,0,0,0,1,0,1
User4790,0,0,1,0,0,1
User4783,0,0,0,1,0,1
User4782,0,0,1,0,0,1
User4780,0,0,0,1,0,1
User4779,0,0,0,1,0,1
User4778,0,0,0,1,0,1
User4776,0,1,0,0,0,1
User4775,0,0,1,0,0,1
User4772,0,1,0,0,0,1
User4768,0,1,0,0,0,1
User4766,0,0,0,1,0,1
User4765,0,1,0,0,0,1
User4764,0,1,0,0,0,1
User4763,0,0,0,0,1,1
User4761,0,0,1,0,0,1
User4760,1,0,0,0,0,1
User4349,0,0,0,1,0,1
User4348,0,1,0,0,0,1
User4346,0,1,0,0,0,1
User3878,0,0,0,1,0,1
User3903,0,1,0,0,0,1
User3902,0,0,0,1,0,1
User3900,0,0,0,1,0,1
User3899,0,1,0,0,0,1
User3898,0,0,0,1,0,1
User3896,0,0,1,0,0,1
User3894,0,1,0,0,0,1
User3893,1,0,0,0,0,1
User3890,0,0,0,1,0,1
User3886,0,0,1,0,0,1
User3883,0,1,0,0,0,1
User3881,1,0,0,0,0,1
User3880,0,0,0,1,0,1
User3879,0,1,0,0,0,1
User3874,0,0,0,1,0,1
User3910,0,1,0,0,0,1
User3872,0,1,0,0,0,1
User3869,0,1,0,0,0,1
User3868,1,0,0,0,0,1
User3867,0,0,0,1,0,1
User3859,1,0,0,0,0,1
User3858,0,0,0,1,0,1
User3857,0,0,0,1,0,1
User3852,0,1,0,0,0,1
User3851,0,1,0,0,0,1
User3850,0,0,0,1,0,1
User3846,0,1,0,0,0,1
User3844,0,0,0,1,0,1
User3842,0,1,0,0,0,1
User3833,1,0,0,0,0,1
User3909,0,0,0,1,0,1
User3911,1,0,0,0,0,1
User4343,0,0,1,0,0,1
User3962,0,0,1,0,0,1
User4015,0,0,1,0,0,1
User4012,0,0,0,1,0,1
User4007,0,0,1,0,0,1
User4003,0,1,0,0,0,1
User4001,1,0,0,0,0,1
User3998,0,0,0,1,0,1
User3994,0,1,0,0,0,1
User3989,0,1,0,0,0,1
User3987,0,0,1,0,0,1
User3981,0,0,0,1,0,1
User3979,0,0,0,0,1,1
User3978,0,0,1,0,0,1
User3971,0,0,0,0,1,1
User3965,0,0,1,0,0,1
User3960,0,0,1,0,0,1
User3915,0,0,1,0,0,1
User3956,0,0,1,0,0,1
User3955,0,1,0,0,0,1
User3954,0,0,0,1,0,1
User3951,0,0,0,1,0,1
User3950,0,0,0,1,0,1
User3940,0,0,0,0,1,1
User3937,0,0,0,1,0,1
User3936,0,0,0,1,0,1
User3931,0,1,0,0,0,1
User3930,0,1,0,0,0,1
User3928,0,0,1,0,0,1
User3922,0,1,0,0,0,1
User3921,0,0,0,1,0,1
User3920,0,1,0,0,0,1
User3832,0,0,0,1,0,1
User3827,0,1,0,0,0,1
User3826,0,0,0,1,0,1
User3694,0,0,0,1,0,1
User3730,0,0,1,0,0,1
User3727,0,0,0,1,0,1
User3726,0,0,0,1,0,1
User3723,1,0,0,0,0,1
User3721,0,0,1,0,0,1
User3717,0,1,0,0,0,1
User3716,0,0,0,1,0,1
User3713,0,1,0,0,0,1
User3712,0,0,0,1,0,1
User3708,0,1,0,0,0,1
User3706,0,0,0,1,0,1
User3700,0,1,0,0,0,1
User3699,0,1,0,0,0,1
User3697,0,0,1,0,0,1
User3691,1,0,0,0,0,1
User3825,0,0,0,1,0,1
User3690,0,0,1,0,0,1
User3686,0,0,1,0,0,1
User3685,0,0,1,0,0,1
User3682,0,0,0,1,0,1
User3680,0,0,1,0,0,1
User3676,0,0,0,1,0,1
User3672,0,1,0,0,0,1
User3669,0,0,0,1,0,1
User3664,0,0,1,0,0,1
User3658,0,0,0,1,0,1
User3655,0,0,1,0,0,1
User3654,0,1,0,0,0,1
User3653,0,0,1,0,0,1
User3652,0,0,0,1,0,1
User3735,0,0,1,0,0,1
User3736,0,1,0,0,0,1
User3737,0,0,1,0,0,1
User3738,0,1,0,0,0,1
User3824,0,1,0,0,0,1
User3823,1,0,0,0,0,1
User3817,0,0,0,1,0,1
User3811,0,1,0,0,0,1
User3809,0,1,0,0,0,1
User3807,0,0,1,0,0,1
User3805,0,0,1,0,0,1
User3801,0,0,1,0,0,1
User3799,1,0,0,0,0,1
User3796,0,1,0,0,0,1
User3791,0,0,0,1,0,1
User3790,0,0,0,1,0,1
User3788,1,0,0,0,0,1
User3786,0,0,0,1,0,1
User3783,0,0,0,1,0,1
User3782,0,0,0,1,0,1
User3778,0,0,1,0,0,1
User3777,0,0,0,1,0,1
User3774,0,0,0,1,0,1
User3769,0,0,1,0,0,1
User3767,0,1,0,0,0,1
User3761,0,1,0,0,0,1
User3760,0,1,0,0,0,1
User3758,0,0,1,0,0,1
User3757,0,0,1,0,0,1
User3754,0,0,1,0,0,1
User3749,0,1,0,0,0,1
User3745,0,0,0,1,0,1
User3742,0,0,0,1,0,1
User4018,0,0,0,1,0,1
User4022,0,1,0,0,0,1
User4023,0,0,1,0,0,1
User4230,0,0,1,0,0,1
User4250,1,0,0,0,0,1
User4248,0,0,1,0,0,1
User4247,0,0,1,0,0,1
User4246,0,0,0,1,0,1
User4245,0,1,0,0,0,1
User4242,0,0,1,0,0,1
User4241,0,1,0,0,0,1
User4239,0,0,0,1,0,1
User4238,0,0,1,0,0,1
User4237,1,0,0,0,0,1
User4236,1,0,0,0,0,1
User4234,0,0,0,1,0,1
User4233,1,0,0,0,0,1
User4232,0,0,1,0,0,1
User4228,0,0,1,0,0,1
User4199,0,0,0,1,0,1
User4226,0,0,1,0,0,1
User4225,0,0,0,1,0,1
User4223,0,0,1,0,0,1
User4221,0,1,0,0,0,1
User4220,0,1,0,0,0,1
User4219,0,0,1,0,0,1
User4217,0,0,0,1,0,1
User4212,0,0,1,0,0,1
User4211,0,1,0,0,0,1
User4210,0,0,1,0,0,1
User4209,0,1,0,0,0,1
User4207,0,0,0,1,0,1
User4203,0,0,0,1,0,1
User4202,0,1,0,0,0,1
User4253,0,0,0,1,0,1
User4254,0,1,0,0,0,1
User4259,0,1,0,0,0,1
User4262,0,1,0,0,0,1
User4336,0,0,0,1,0,1
User4334,0,0,0,1,0,1
User4333,0,0,1,0,0,1
User4327,0,0,0,1,0,1
User4323,0,0,0,1,0,1
User4322,0,1,0,0,0,1
User4320,0,0,1,0,0,1
User4316,0,1,0,0,0,1
User4314,0,1,0,0,0,1
User4312,1,0,0,0,0,1
User4311,0,1,0,0,0,1
User4309,0,0,1,0,0,1
User4308,0,0,0,1,0,1
User4305,0,1,0,0,0,1
User4304,0,0,0,1,0,1
User4303,1,0,0,0,0,1
User4302,0,0,1,0,0,1
User4296,0,1,0,0,0,1
User4294,0,1,0,0,0,1
User4290,0,1,0,0,0,1
User4288,0,1,0,0,0,1
User4284,0,0,1,0,0,1
User4278,0,0,1,0,0,1
User4275,0,1,0,0,0,1
User4272,0,0,1,0,0,1
User4269,0,0,1,0,0,1
User4268,0,1,0,0,0,1
User4267,0,0,0,1,0,1
User4265,0,0,1,0,0,1
User4201,0,0,1,0,0,1
User4198,1,0,0,0,0,1
User4026,0,1,0,0,0,1
User4066,1,0,0,0,0,1
User4112,0,0,0,1,0,1
User4108,0,1,0,0,0,1
User4105,0,1,0,0,0,1
User4098,0,0,1,0,0,1
User4097,0,1,0,0,0,1
User4085,0,1,0,0,0,1
User4084,0,0,0,1,0,1
User4081,0,0,1,0,0,1
User4080,0,0,0,1,0,1
User4076,0,1,0,0,0,1
User4074,0,0,1,0,0,1
User4070,0,1,0,0,0,1
User4069,0,0,0,1,0,1
User4068,0,1,0,0,0,1
User4064,0,1,0,0,0,1
User4196,0,1,0,0,0,1
User4063,0,0,1,0,0,1
User4061,0,0,1,0,0,1
User4057,0,0,0,1,0,1
User4056,0,0,1,0,0,1
User4055,0,0,0,1,0,1
User4054,0,1,0,0,0,1
User4053,0,1,0,0,0,1
User4051,0,0,1,0,0,1
User4049,0,0,1,0,0,1
User4047,0,0,1,0,0,1
User4046,1,0,0,0,0,1
User4037,0,0,1,0,0,1
User4035,0,1,0,0,0,1
User4031,0,0,1,0,0,1
User4113,0,0,0,0,1,1
User4118,0,0,1,0,0,1
User4120,0,1,0,0,0,1
User4121,0,0,0,1,0,1
User4192,0,0,0,1,0,1
User4190,0,0,0,1,0,1
User4189,0,1,0,0,0,1
User4183,1,0,0,0,0,1
User4178,0,0,1,0,0,1
User4177,0,0,1,0,0,1
User4176,1,0,0,0,0,1
User4173,0,0,0,1,0,1
User4172,0,0,1,0,0,1
User4168,1,0,0,0,0,1
User4164,0,0,1,0,0,1
User4161,0,1,0,0,0,1
User4160,0,0,0,1,0,1
User4158,0,1,0,0,0,1
User4156,1,0,0,0,0,1
User4155,0,1,0,0,0,1
User4154,0,0,1,0,0,1
User4152,1,0,0,0,0,1
User4151,0,0,0,1,0,1
User4145,0,1,0,0,0,1
User4142,0,0,0,1,0,1
User4138,0,1,0,0,0,1
User4137,1,0,0,0,0,1
User4136,0,0,1,0,0,1
User4134,0,0,0,1,0,1
User4132,0,0,1,0,0,1
User4129,0,1,0,0,0,1
User4127,0,1,0,0,0,1
User4122,0,1,0,0,0,1
User6060,0,0,0,0,1,1
